Name	Team	Date*	Location	K1	K2	P1	P2	S1	S2	Total	SB Centers	A1	A2	A3	A4	A5	A6	Total	AR Centers
Billy Azzinaro	Kentucky	Sep. 21, 2016	Ole Miss	96	96	99	97	95	95	578	23	100	100	93	98	99	98	588	45
Jenna Bethea	Kentucky	Sep. 21, 2016	Ole Miss	0	0	0	0	0	0	0	0	0	0	0	0	0	0	0	0
Hanna Carr	Kentucky	Sep. 21, 2016	Ole Miss	97	98	99	100	97	91	582	27	100	99	99	100	99	98	595	43
Morgan Duerr	Kentucky	Sep. 21, 2016	Ole Miss	0	0	0	0	0	0	0	0	0	0	0	0	0	0	0	0
Ian Foos	Kentucky	Sep. 21, 2016	Ole Miss	0	0	0	0	0	0	0	0	0	0	0	0	0	0	0	0
Carmen Fry	Kentucky	Sep. 21, 2016	Ole Miss	0	0	0	0	0	0	0	0	0	0	0	0	0	0	0	0
Heather Kirby	Kentucky	Sep. 21, 2016	Ole Miss	96	97	98	97	97	92	577	20	98	99	98	99	100	99	593	45
Sonya May	Kentucky	Sep. 21, 2016	Ole Miss	97	92	100	98	92	90	569	21	100	96	97	99	99	100	591	44
Andrew Miller	Kentucky	Sep. 21, 2016	Ole Miss	0	0	0	0	0	0	0	0	0	0	0	0	0	0	0	0
Cathryn Papasodora	Kentucky	Sep. 21, 2016	Ole Miss	95	91	95	96	95	98	570	21	98	100	99	97	97	99	590	34
Jason Scharbel	Kentucky	Sep. 21, 2016	Ole Miss	0	0	0	0	0	0	0	0	0	0	0	0	0	0	0	0
Jason Spaude	Kentucky	Sep. 21, 2016	Ole Miss	93	96	99	99	94	93	574	24	97	98	99	99	97	97	587	36
Bobby Broadstreet	Murray St.	Sep. 21, 2016	Ole Miss	94	95	100	100	91	91	571	23	98	97	99	99	98	98	589	39
Meike Drewell	Murray St.	Sep. 21, 2016	Ole Miss	97	95	100	98	96	96	582	35	98	97	98	98	98	98	587	33
Ben Estes	Murray St.	Sep. 21, 2016	Ole Miss	97	95	99	97	95	94	577	28	99	97	100	97	100	98	591	43
Shelby Huber	Murray St.	Sep. 21, 2016	Ole Miss	96	92	99	99	89	91	566	20	97	96	96	94	96	99	578	31
Mackenzie Martin	Murray St.	Sep. 21, 2016	Ole Miss	95	96	98	99	96	92	576	23	99	99	98	98	99	99	592	42
Ivan Roe	Murray St.	Sep. 21, 2016	Ole Miss	99	99	99	98	100	96	591	34	98	100	98	100	99	97	592	44
Barbara Schlapfer	Murray St.	Sep. 21, 2016	Ole Miss	0	0	0	0	0	0	0	0	0	0	0	0	0	0	0	0
Alathea Sellars	Murray St.	Sep. 21, 2016	Ole Miss	0	0	0	0	0	0	0	0	0	0	0	0	0	0	0	0
Eric Sloan	Murray St.	Sep. 21, 2016	Ole Miss	89	83	100	97	91	91	551	20	95	98	95	97	96	96	577	25
Andrew Abernathy	North Georgia	Sep. 21, 2016	Ole Miss	0	0	0	0	0	0	0	0	0	0	0	0	0	0	0	0
Eric Azotea	North Georgia	Sep. 21, 2016	Ole Miss	0	0	0	0	0	0	0	0	0	0	0	0	0	0	0	0
Ruthanne Conner	North Georgia	Sep. 21, 2016	Ole Miss	95	94	96	97	93	93	568	19	97	97	100	98	97	97	586	36
Lucas Gilliland	North Georgia	Sep. 21, 2016	Ole Miss	88	89	98	96	85	86	542	18	92	95	95	97	95	95	569	25
Maddie Godwin	North Georgia	Sep. 21, 2016	Ole Miss	0	0	0	0	0	0	0	0	0	0	0	0	0	0	0	0
Hannah Peevy	North Georgia	Sep. 21, 2016	Ole Miss	0	0	0	0	0	0	0	0	0	0	0	0	0	0	0	0
Jared Rice	North Georgia	Sep. 21, 2016	Ole Miss	92	94	100	99	84	91	560	17	95	98	98	97	94	90	572	31
Tobin Sanctuary	North Georgia	Sep. 21, 2016	Ole Miss	95	91	96	99	94	88	563	18	96	94	96	96	96	93	571	23
Brianna Shaw	North Georgia	Sep. 21, 2016	Ole Miss	89	91	97	95	91	87	550	12	95	96	96	94	93	92	566	16
Dakota Spivey	North Georgia	Sep. 21, 2016	Ole Miss	91	91	100	98	96	93	569	25	100	97	99	95	99	96	586	36
David Turner	North Georgia	Sep. 21, 2016	Ole Miss	90	93	96	98	83	86	546	16	93	96	94	96	95	94	568	21
Hayley Carroll	Ole Miss	Sep. 21, 2016	Ole Miss	92	94	98	98	89	86	557	17	96	100	99	98	99	98	590	40
Harley Gardner	Ole Miss	Sep. 21, 2016	Ole Miss	96	96	96	99	96	93	576	28	98	97	97	96	97	98	583	28
Jess Haig	Ole Miss	Sep. 21, 2016	Ole Miss	94	91	99	100	93	94	571	23	97	98	98	98	98	99	588	42
Alana Kelly	Ole Miss	Sep. 21, 2016	Ole Miss	95	94	97	97	90	93	566	16	97	96	92	92	98	96	571	24
Randi Loudin	Ole Miss	Sep. 21, 2016	Ole Miss	97	98	99	99	94	90	577	29	92	96	97	95	98	93	571	27
Marina Noble	Ole Miss	Sep. 21, 2016	Ole Miss	88	96	97	97	95	90	563	20	0	0	0	0	0	0	0	0
Samantha Sandifer	Ole Miss	Sep. 21, 2016	Ole Miss	91	94	94	97	93	91	560	13	96	98	95	91	94	94	568	20
Kristyn Trump	Ole Miss	Sep. 21, 2016	Ole Miss	97	93	99	98	89	87	563	21	98	94	94	96	95	95	572	23
Jillian Tyler	Ole Miss	Sep. 21, 2016	Ole Miss	87	92	92	98	92	91	552	13	95	95	96	100	98	95	579	27
Ali Weisz	Ole Miss	Sep. 21, 2016	Ole Miss	96	96	99	97	95	93	576	29	100	99	97	98	98	99	591	46
Alex Bapties	UT Martin	Sep. 21, 2016	Ole Miss	0	0	0	0	0	0	0	0	93	93	94	95	96	99	570	25
Erin Bell	UT Martin (W)	Sep. 21, 2016	Ole Miss	0	0	0	0	0	0	0	0	0	0	0	0	0	0	0	0
Brigitte Curcio	UT Martin	Sep. 21, 2016	Ole Miss	92	92	98	94	94	94	564	25	97	99	97	98	96	96	583	36
Andre Delcalzo	UT Martin	Sep. 21, 2016	Ole Miss	91	95	95	97	89	88	555	14	0	0	0	0	0	0	0	0
Logan Hunt	UT Martin	Sep. 21, 2016	Ole Miss	92	88	93	84	85	85	527	6	95	97	93	96	96	95	572	26
Kaitlin Korinek	UT Martin	Sep. 21, 2016	Ole Miss	92	99	97	97	93	93	571	16	97	96	98	98	99	99	587	35
Joe Martin	UT Martin	Sep. 21, 2016	Ole Miss	94	100	99	100	90	97	580	28	97	99	97	97	98	99	587	34
Amanda Mayo	UT Martin (W)	Sep. 21, 2016	Ole Miss	93	94	96	98	84	70	535	15	90	88	95	89	90	92	544	11
Alex Tamboli	UT Martin	Sep. 21, 2016	Ole Miss	95	91	95	94	89	90	554	11	94	96	95	94	95	96	570	24
Jack Berhorst	Memphis	Sep. 21, 2016	Ole Miss	96	99	98	100	97	94	584	29	97	99	98	95	98	95	582	31
Haylea Broughton	Memphis	Sep. 21, 2016	Ole Miss	93	98	95	99	95	92	572	24	98	96	97	98	99	97	585	36
Levi Clark	Memphis	Sep. 21, 2016	Ole Miss	93	96	100	100	89	93	571	27	98	96	99	99	97	96	585	37
Leighton Dempster	Memphis	Sep. 21, 2016	Ole Miss	94	91	98	99	91	93	566	16	96	96	97	97	98	99	583	33
Makennon Doran	Memphis	Sep. 21, 2016	Ole Miss	92	97	94	94	93	92	562	16	98	96	97	98	99	94	582	40
Amberlie Ezell	Memphis	Sep. 21, 2016	Ole Miss	95	93	99	97	91	92	567	20	98	95	97	94	94	95	573	26
Amy Fister	Memphis	Sep. 21, 2016	Ole Miss	97	98	98	100	98	94	585	32	98	96	98	97	96	99	584	34
Eli Rischling	Memphis	Sep. 21, 2016	Ole Miss	93	95	97	100	91	89	565	21	95	98	96	96	95	97	577	28
Abby Votava	Memphis	Sep. 21, 2016	Ole Miss	80	87	94	91	86	86	524	5	96	94	95	96	97	93	571	24
Hunter Behrends	Jacksonville St.	Sep. 21, 2016	Ole Miss	0	0	0	0	0	0	0	0	0	0	0	0	0	0	0	0
Austin Cock	Jacksonville St.	Sep. 21, 2016	Ole Miss	95	94	97	99	94	91	570	24	97	96	97	97	97	97	581	31
Anika Corsi	Jacksonville St.	Sep. 21, 2016	Ole Miss	0	0	0	0	0	0	0	0	0	0	0	0	0	0	0	0
Trace Haynes	Jacksonville St.	Sep. 21, 2016	Ole Miss	95	96	97	96	93	92	569	15	97	99	96	97	96	100	585	39
Brandon Henson	Jacksonville St.	Sep. 21, 2016	Ole Miss	0	0	0	0	0	0	0	0	0	0	0	0	0	0	0	0
Brandon Muske	Jacksonville St.	Sep. 21, 2016	Ole Miss	92	96	99	95	94	93	569	21	98	98	99	100	97	100	592	46
Garrett Rabel	Jacksonville St.	Sep. 21, 2016	Ole Miss	94	95	98	100	91	90	568	23	0	0	0	0	0	0	0	0
Tyler Ramos	Jacksonville St.	Sep. 21, 2016	Ole Miss	98	96	98	95	91	92	570	23	96	97	96	98	94	98	579	24
Mekenna Richardson	Jacksonville St.	Sep. 21, 2016	Ole Miss	97	98	98	99	95	96	583	29	98	94	96	94	94	98	574	26
Carter Santrock	Jacksonville St.	Sep. 21, 2016	Ole Miss	95	96	99	96	93	94	573	30	98	94	96	98	99	97	582	35
David Sink	Jacksonville St.	Sep. 21, 2016	Ole Miss	96	96	97	98	91	91	569	21	100	97	98	99	96	95	585	36
Ashley Coots	UT Martin (W)	Sep. 21, 2016	Ole Miss	92	96	96	95	90	89	558	14	96	98	94	97	97	97	579	24
Lindsey Flint	UT Martin (W)	Sep. 21, 2016	Ole Miss	0	0	0	0	0	0	0	0	0	0	0	0	0	0	0	0
Brianna Sawyers	UT Martin (W)	Sep. 21, 2016	Ole Miss	95	92	94	99	94	91	565	15	94	94	91	93	96	97	565	25
Alyson Sylvester	UT Martin (W)	Sep. 21, 2016	Ole Miss	93	95	93	97	93	93	564	15	96	96	95	97	91	95	570	25
Kyle Ordille	Jacksonville St.	Sep. 21, 2016	Ole Miss	0	0	0	0	0	0	0	0	0	0	0	0	0	0	0	0
Carleigh Peters	Jacksonville St.	Sep. 21, 2016	Ole Miss	0	0	0	0	0	0	0	0	92	97	97	97	96	98	577	25
Zach Schmidt	Jacksonville St.	Sep. 21, 2016	Ole Miss	94	97	98	97	91	92	569	22	98	98	96	96	96	95	579	35
Jennifer Plocinik	UT Martin (W)	Sep. 21, 2016	Ole Miss	93	96	98	96	91	88	562	16	95	97	92	95	99	95	573	25
Allison Auten	Citadel	Sep. 24, 2016	VMI	90	91	91	94	91	93	550	0	93	92	90	94	94	96	559	0
Matthew Davenport	Citadel	Sep. 24, 2016	VMI	0	0	0	0	0	0	0	0	0	0	0	0	0	0	0	0
Joseph Ferguson	Citadel	Sep. 24, 2016	VMI	0	0	0	0	0	0	0	0	0	0	0	0	0	0	0	0
Morgan Long	Citadel	Sep. 24, 2016	VMI	92	93	96	92	88	95	556	0	98	94	96	95	97	97	577	0
Alexander McAlear	Citadel	Sep. 24, 2016	VMI	89	94	93	96	86	83	541	0	98	92	94	95	96	93	568	0
Patrick Meyer	Citadel	Sep. 24, 2016	VMI	93	91	98	95	76	80	533	0	88	89	88	92	91	94	542	0
Richie Parra	Citadel	Sep. 24, 2016	VMI	0	0	0	0	0	0	0	0	97	96	93	93	92	94	565	0
Colton Poole	Citadel	Sep. 24, 2016	VMI	92	90	95	92	86	93	548	0	90	91	94	95	97	96	563	0
Tommy Simrill	Citadel	Sep. 24, 2016	VMI	84	85	95	98	82	85	529	0	89	89	95	92	91	93	549	0
William Davidson	VMI	Sep. 24, 2016	VMI	0	0	0	0	0	0	0	0	0	0	0	0	0	0	0	0
Andrew Hickey	VMI	Sep. 24, 2016	VMI	92	92	98	96	89	87	554	0	92	95	96	97	97	95	572	0
Jacob Hunter	VMI	Sep. 24, 2016	VMI	0	0	0	0	0	0	0	0	96	95	95	94	94	97	571	0
Zachary Johnson	VMI	Sep. 24, 2016	VMI	92	94	97	96	89	91	559	0	0	0	0	0	0	0	0	0
Mathew Lusardi	VMI	Sep. 24, 2016	VMI	90	89	98	98	90	86	551	0	95	91	92	91	89	89	547	0
Chris Milliken	VMI	Sep. 24, 2016	VMI	0	0	0	0	0	0	0	0	97	92	94	94	97	92	566	0
John Pitman	VMI	Sep. 24, 2016	VMI	0	0	0	0	0	0	0	0	0	0	0	0	0	0	0	0
Nick Reynolds	VMI	Sep. 24, 2016	VMI	94	92	93	95	83	86	543	0	91	92	93	96	97	94	563	0
Carli Cline	Citadel (W)	Sep. 24, 2016	VMI	83	92	94	93	68	62	492	0	84	80	83	84	80	90	501	0
Brandi Duzz	Citadel (W)	Sep. 24, 2016	VMI	79	87	96	98	77	77	514	0	93	89	88	90	98	89	547	0
Leah Fenwrick-Wallace	Citadel (W)	Sep. 24, 2016	VMI	90	77	91	89	88	84	519	0	91	93	91	89	90	93	547	0
Shadonna Littlejohn	Citadel (W)	Sep. 24, 2016	VMI	0	0	0	0	0	0	0	0	0	0	0	0	0	0	0	0
Tierra Price	Citadel (W)	Sep. 24, 2016	VMI	0	0	0	0	0	0	0	0	0	0	0	0	0	0	0	0
Faith Totherow	Citadel (W)	Sep. 24, 2016	VMI	87	86	92	90	82	79	516	0	82	81	84	87	88	81	503	0
Raven Wills	Citadel (W)	Sep. 24, 2016	VMI	0	0	0	0	0	0	0	0	0	0	0	0	0	0	0	0
Kelia Aardema	VMI (W)	Sep. 24, 2016	VMI	0	0	0	0	0	0	0	0	0	0	0	0	0	0	0	0
Samantha Alexander	VMI (W)	Sep. 24, 2016	VMI	94	87	96	94	85	82	538	0	94	96	94	96	94	97	571	0
Ellana Avery	VMI (W)	Sep. 24, 2016	VMI	95	87	93	96	83	81	535	0	0	0	0	0	0	0	0	0
Sabrina Bell	VMI (W)	Sep. 24, 2016	VMI	0	0	0	0	0	0	0	0	0	0	0	0	0	0	0	0
Alice Chiu	VMI (W)	Sep. 24, 2016	VMI	94	91	96	91	87	83	542	0	96	94	96	96	90	97	569	0
Jamie Foster	VMI (W)	Sep. 24, 2016	VMI	0	0	0	0	0	0	0	0	0	0	0	0	0	0	0	0
Joelle Henry	VMI (W)	Sep. 24, 2016	VMI	0	0	0	0	0	0	0	0	0	0	0	0	0	0	0	0
Rachel Jankelow	VMI (W)	Sep. 24, 2016	VMI	0	0	0	0	0	0	0	0	93	91	92	94	93	94	557	0
Kerrie Lightfoot	VMI (W)	Sep. 24, 2016	VMI	0	0	0	0	0	0	0	0	0	0	0	0	0	0	0	0
Loyce Lightfoot	VMI (W)	Sep. 24, 2016	VMI	89	92	92	92	90	89	544	0	93	91	91	91	94	90	550	0
Kaitlyn Morrison	VMI (W)	Sep. 24, 2016	VMI	0	0	0	0	0	0	0	0	0	0	0	0	0	0	0	0
Katherine Watson	VMI (W)	Sep. 24, 2016	VMI	85	85	94	90	83	87	524	0	90	97	94	95	94	97	567	0
Lauryn Cinadr	Akron	Sep. 24, 2016	Memphis	0	0	0	0	0	0	0	0	0	0	0	0	0	0	0	0
Alex Fedorko	Akron	Sep. 24, 2016	Memphis	0	0	0	0	0	0	0	0	0	0	0	0	0	0	0	0
Sydney Goldschlag	Akron	Sep. 24, 2016	Memphis	0	0	0	0	0	0	0	0	0	0	0	0	0	0	0	0
Rebecca Green	Akron	Sep. 24, 2016	Memphis	0	0	0	0	0	0	0	0	0	0	0	0	0	0	0	0
Julia Hatch	Akron	Sep. 24, 2016	Memphis	95	98	99	97	94	95	578	22	97	95	98	94	95	98	577	28
Anthony Jackson	Akron	Sep. 24, 2016	Memphis	0	0	0	0	0	0	0	0	97	94	96	96	98	94	575	24
Kera Kaufman	Akron	Sep. 24, 2016	Memphis	0	0	0	0	0	0	0	0	0	0	0	0	0	0	0	0
Joshua Kovach	Akron	Sep. 24, 2016	Memphis	0	0	0	0	0	0	0	0	0	0	0	0	0	0	0	0
Caleb Lloyd	Akron	Sep. 24, 2016	Memphis	96	95	98	98	92	92	571	25	0	0	0	0	0	0	0	0
Danielle Makucevich	Akron	Sep. 24, 2016	Memphis	0	0	0	0	0	0	0	0	0	0	0	0	0	0	0	0
Kris Mantel	Akron	Sep. 24, 2016	Memphis	0	0	0	0	0	0	0	0	0	0	0	0	0	0	0	0
Brent Morgan	Akron	Sep. 24, 2016	Memphis	0	0	0	0	0	0	0	0	0	0	0	0	0	0	0	0
Connor O'Mara	Akron	Sep. 24, 2016	Memphis	91	95	97	96	89	92	560	18	92	95	97	96	98	98	576	28
Marlee Reynolds	Akron	Sep. 24, 2016	Memphis	0	0	0	0	0	0	0	0	0	0	0	0	0	0	0	0
Sean Roehrs	Akron	Sep. 24, 2016	Memphis	0	0	0	0	0	0	0	0	0	0	0	0	0	0	0	0
Zach Strohl	Akron	Sep. 24, 2016	Memphis	96	97	98	99	91	92	573	24	100	98	97	98	98	96	587	33
Cierra Terrizzi	Akron	Sep. 24, 2016	Memphis	92	92	99	99	95	98	575	24	98	95	97	100	98	97	585	37
Hayley Carroll	Ole Miss	Sep. 24, 2016	Memphis	0	0	0	0	0	0	0	0	95	98	98	97	98	98	584	37
Harley Gardner	Ole Miss	Sep. 24, 2016	Memphis	95	99	99	97	96	93	579	24	97	100	99	99	98	98	591	39
Jess Haig	Ole Miss	Sep. 24, 2016	Memphis	96	94	100	98	90	93	571	22	100	97	98	99	98	99	591	43
Alana Kelly	Ole Miss	Sep. 24, 2016	Memphis	94	97	98	98	98	93	578	34	97	96	95	96	98	97	579	29
Randi Loudin	Ole Miss	Sep. 24, 2016	Memphis	97	93	98	99	89	86	562	22	96	100	99	97	97	93	582	32
Marina Noble	Ole Miss	Sep. 24, 2016	Memphis	92	93	99	98	93	90	565	19	0	0	0	0	0	0	0	0
Samantha Sandifer	Ole Miss	Sep. 24, 2016	Memphis	0	0	0	0	0	0	0	0	97	96	96	95	96	95	575	33
Kristyn Trump	Ole Miss	Sep. 24, 2016	Memphis	95	90	99	98	89	91	562	20	95	98	97	97	94	98	579	27
Jillian Tyler	Ole Miss	Sep. 24, 2016	Memphis	90	96	96	98	89	93	562	12	98	98	96	93	97	97	579	36
Ali Weisz	Ole Miss	Sep. 24, 2016	Memphis	96	99	99	100	95	94	583	32	99	100	99	95	98	97	588	43
Alex Bapties	UT Martin	Sep. 24, 2016	Memphis	0	0	0	0	0	0	0	0	91	97	93	93	97	94	565	26
Brigitte Curcio	UT Martin	Sep. 24, 2016	Memphis	90	93	96	95	92	91	557	18	97	98	96	98	95	96	580	26
Andre Delcalzo	UT Martin	Sep. 24, 2016	Memphis	0	0	0	0	0	0	0	0	0	0	0	0	0	0	0	0
Logan Hunt	UT Martin	Sep. 24, 2016	Memphis	93	91	93	92	90	81	540	9	0	0	0	0	0	0	0	0
Kaitlin Korinek	UT Martin	Sep. 24, 2016	Memphis	92	92	94	96	95	95	564	17	95	97	94	96	95	96	573	29
Joe Martin	UT Martin	Sep. 24, 2016	Memphis	97	99	99	100	93	93	581	33	98	96	97	97	100	98	586	36
Alex Tamboli	UT Martin	Sep. 24, 2016	Memphis	92	94	92	93	92	89	552	12	99	94	94	94	95	92	568	22
Jack Berhorst	Memphis	Sep. 24, 2016	Memphis	98	97	99	100	89	95	578	28	88	97	94	98	95	99	571	30
Haylea Broughton	Memphis	Sep. 24, 2016	Memphis	93	93	95	98	96	95	570	25	98	97	97	98	99	100	589	40
Levi Clark	Memphis	Sep. 24, 2016	Memphis	97	99	99	100	91	91	577	24	96	98	97	100	97	96	584	32
Leighton Dempster	Memphis	Sep. 24, 2016	Memphis	96	94	97	98	92	90	567	20	97	99	97	100	97	97	587	42
Makennon Doran	Memphis	Sep. 24, 2016	Memphis	93	95	95	96	94	92	565	0	98	98	96	97	99	99	587	39
Amberlie Ezell	Memphis	Sep. 24, 2016	Memphis	96	92	97	97	93	93	568	0	96	92	94	93	94	96	565	21
Amy Fister	Memphis	Sep. 24, 2016	Memphis	96	98	99	98	97	97	585	31	98	98	98	97	97	97	585	32
Eli Rischling	Memphis	Sep. 24, 2016	Memphis	96	92	98	98	93	95	572	0	96	96	96	94	97	97	576	26
Abby Votava	Memphis	Sep. 24, 2016	Memphis	89	91	96	97	85	94	552	0	98	97	94	95	94	92	570	25
Hunter Behrends	Jacksonville St.	Sep. 24, 2016	Memphis	0	0	0	0	0	0	0	0	0	0	0	0	0	0	0	0
Austin Cock	Jacksonville St.	Sep. 24, 2016	Memphis	0	0	0	0	0	0	0	0	0	0	0	0	0	0	0	0
Anika Corsi	Jacksonville St.	Sep. 24, 2016	Memphis	0	0	0	0	0	0	0	0	0	0	0	0	0	0	0	0
Trace Haynes	Jacksonville St.	Sep. 24, 2016	Memphis	93	96	96	100	92	86	563	18	96	97	96	94	95	97	575	25
Brandon Henson	Jacksonville St.	Sep. 24, 2016	Memphis	0	0	0	0	0	0	0	0	0	0	0	0	0	0	0	0
Brandon Muske	Jacksonville St.	Sep. 24, 2016	Memphis	94	95	98	95	93	94	569	18	99	100	99	99	99	98	594	48
Kyle Ordille	Jacksonville St.	Sep. 24, 2016	Memphis	0	0	0	0	0	0	0	0	0	0	0	0	0	0	0	0
Carleigh Peters	Jacksonville St.	Sep. 24, 2016	Memphis	0	0	0	0	0	0	0	0	97	98	98	97	100	97	587	40
Garrett Rabel	Jacksonville St.	Sep. 24, 2016	Memphis	95	95	98	99	87	91	565	22	0	0	0	0	0	0	0	0
Tyler Ramos	Jacksonville St.	Sep. 24, 2016	Memphis	98	97	100	99	90	92	576	25	0	0	0	0	0	0	0	0
Mekenna Richardson	Jacksonville St.	Sep. 24, 2016	Memphis	100	96	98	98	90	92	574	18	0	0	0	0	0	0	0	0
Carter Santrock	Jacksonville St.	Sep. 24, 2016	Memphis	0	0	0	0	0	0	0	0	96	97	97	97	93	98	578	31
Zach Schmidt	Jacksonville St.	Sep. 24, 2016	Memphis	0	0	0	0	0	0	0	0	0	0	0	0	0	0	0	0
David Sink	Jacksonville St.	Sep. 24, 2016	Memphis	0	0	0	0	0	0	0	0	96	98	97	98	99	97	585	39
Sarah Banks	Alabama Birmingham	Sep. 24, 2016	Memphis	0	0	0	0	0	0	0	0	95	96	97	95	99	94	576	28
Steven Bugg	Alabama Birmingham	Sep. 24, 2016	Memphis	0	0	0	0	0	0	0	0	85	81	88	89	85	89	517	12
Selina Curren	Alabama Birmingham	Sep. 24, 2016	Memphis	0	0	0	0	0	0	0	0	94	95	92	96	92	93	562	15
Lindsey Hill	Alabama Birmingham	Sep. 24, 2016	Memphis	0	0	0	0	0	0	0	0	0	0	0	0	0	0	0	0
Isaac King	Alabama Birmingham	Sep. 24, 2016	Memphis	0	0	0	0	0	0	0	0	0	0	0	0	0	0	0	0
Kristie Lloyd	Alabama Birmingham	Sep. 24, 2016	Memphis	0	0	0	0	0	0	0	0	94	93	88	93	89	90	547	13
Logan Short	Alabama Birmingham	Sep. 24, 2016	Memphis	0	0	0	0	0	0	0	0	0	0	0	0	0	0	0	0
Mallory Sisk	Alabama Birmingham	Sep. 24, 2016	Memphis	0	0	0	0	0	0	0	0	0	0	0	0	0	0	0	0
Micah Smith	Alabama Birmingham	Sep. 24, 2016	Memphis	0	0	0	0	0	0	0	0	0	0	0	0	0	0	0	0
Emily Stover	Alabama Birmingham	Sep. 24, 2016	Memphis	0	0	0	0	0	0	0	0	93	87	92	88	92	92	544	15
Ella Von Canon	Alabama Birmingham	Sep. 24, 2016	Memphis	0	0	0	0	0	0	0	0	0	0	0	0	0	0	0	0
Lilly Vonderau	Alabama Birmingham	Sep. 24, 2016	Memphis	91	88	97	98	89	89	552	18	93	94	90	97	97	92	563	23
Erin Bell	UT Martin (W)	Sep. 24, 2016	Memphis	0	0	0	0	0	0	0	0	0	0	0	0	0	0	0	0
Ashley Coots	UT Martin (W)	Sep. 24, 2016	Memphis	91	95	96	97	86	90	555	18	96	98	94	94	97	98	577	27
Lindsey Flint	UT Martin (W)	Sep. 24, 2016	Memphis	91	94	93	93	88	92	551	9	94	95	95	90	93	93	560	24
Amanda Mayo	UT Martin (W)	Sep. 24, 2016	Memphis	0	0	0	0	0	0	0	0	0	0	0	0	0	0	0	0
Jennifer Plocinik	UT Martin (W)	Sep. 24, 2016	Memphis	92	91	95	98	87	84	547	13	96	94	95	98	94	95	572	27
Brianna Sawyers	UT Martin (W)	Sep. 24, 2016	Memphis	95	92	98	96	90	95	566	19	95	93	98	98	97	94	575	25
Alyson Sylvester	UT Martin (W)	Sep. 24, 2016	Memphis	92	94	95	94	87	90	552	16	91	93	95	93	97	95	564	28
Rachel Benesh	Nevada	Sep. 24, 2016	Nevada Reno	0	0	0	0	0	0	0	0	99	99	99	99	98	99	593	0
Emily Capaul	Nevada	Sep. 24, 2016	Nevada Reno	91	96	98	98	93	88	564	0	99	99	98	96	98	99	589	0
Jared Crews	Nevada	Sep. 24, 2016	Nevada Reno	0	0	0	0	0	0	0	0	0	0	0	0	0	0	0	0
Maneva Gill	Nevada	Sep. 24, 2016	Nevada Reno	0	0	0	0	0	0	0	0	99	96	99	97	99	94	584	0
Sarah Jameson	Nevada	Sep. 24, 2016	Nevada Reno	95	96	99	100	96	94	580	0	98	98	99	98	97	97	587	0
Eli Larimer	Nevada	Sep. 24, 2016	Nevada Reno	93	97	97	98	89	95	569	0	98	97	100	97	96	99	587	0
Justin Nissen	Nevada	Sep. 24, 2016	Nevada Reno	94	97	97	98	91	92	569	0	96	98	99	98	95	98	584	0
Jami Sexton	Nevada	Sep. 24, 2016	Nevada Reno	0	0	0	0	0	0	0	0	0	0	0	0	0	0	0	0
Sara Tashima	Nevada	Sep. 24, 2016	Nevada Reno	0	0	0	0	0	0	0	0	0	0	0	0	0	0	0	0
Mitchell Van Patten	Nevada	Sep. 24, 2016	Nevada Reno	99	97	95	100	97	97	585	0	96	99	99	99	98	98	589	0
Deanna Binnie	Ohio State	Sep. 24, 2016	Nevada Reno	0	0	0	0	0	0	0	0	0	0	0	0	0	0	0	0
Josh Black	Ohio State	Sep. 24, 2016	Nevada Reno	96	93	100	99	93	96	577	0	96	98	98	99	100	99	590	0
Jacob Buchanan	Ohio State	Sep. 24, 2016	Nevada Reno	97	98	97	99	93	95	579	0	97	97	97	97	98	99	585	0
Drew Cheezum	Ohio State	Sep. 24, 2016	Nevada Reno	95	96	97	98	94	98	578	0	100	97	99	100	100	96	592	0
Anthony Cuozzo	Ohio State	Sep. 24, 2016	Nevada Reno	0	0	0	0	0	0	0	0	0	0	0	0	0	0	0	0
Kendal Elder	Ohio State	Sep. 24, 2016	Nevada Reno	0	0	0	0	0	0	0	0	0	0	0	0	0	0	0	0
Alli Kissell	Ohio State	Sep. 24, 2016	Nevada Reno	0	0	0	0	0	0	0	0	0	0	0	0	0	0	0	0
Mark Matheny	Ohio State	Sep. 24, 2016	Nevada Reno	91	97	97	99	93	93	570	0	98	98	99	96	97	95	583	0
Patrick Sardo	Ohio State	Sep. 24, 2016	Nevada Reno	0	0	0	0	0	0	0	0	0	0	0	0	0	0	0	0
Michael Steinel	Ohio State	Sep. 24, 2016	Nevada Reno	97	96	99	98	94	95	579	0	97	97	99	97	97	97	584	0
Chrissy Thomas	Ohio State	Sep. 24, 2016	Nevada Reno	0	0	0	0	0	0	0	0	0	0	0	0	0	0	0	0
Rhiann Travis	Ohio State	Sep. 24, 2016	Nevada Reno	91	96	99	99	95	95	575	0	98	98	100	100	97	99	592	0
Bailey Urbach	Ohio State	Sep. 24, 2016	Nevada Reno	0	0	0	0	0	0	0	0	0	0	0	0	0	0	0	0
Brendan Whitaker	Ohio State	Sep. 24, 2016	Nevada Reno	0	0	0	0	0	0	0	0	0	0	0	0	0	0	0	0
Quintin Wotring	Ohio State	Sep. 24, 2016	Nevada Reno	95	93	100	99	98	91	576	0	97	95	98	94	96	96	576	0
Bobby Broadstreet	Murray St.	Sep. 25, 2016	Murray St.	94	95	100	100	96	95	580	33	89	98	95	98	97	99	576	30
Meike Drewell	Murray St.	Sep. 25, 2016	Murray St.	95	93	99	100	95	96	578	21	96	93	97	94	99	97	576	30
Ben Estes	Murray St.	Sep. 25, 2016	Murray St.	96	98	97	98	97	96	582	31	99	99	99	99	98	98	592	44
Shelby Huber	Murray St.	Sep. 25, 2016	Murray St.	94	97	97	98	92	92	570	18	94	97	98	95	96	97	577	31
Mackenzie Martin	Murray St.	Sep. 25, 2016	Murray St.	96	95	100	100	94	95	580	29	98	96	100	100	100	99	593	46
Ivan Roe	Murray St.	Sep. 25, 2016	Murray St.	97	99	99	100	97	97	589	33	98	99	100	98	99	97	591	44
Barbara Schlapfer	Murray St.	Sep. 25, 2016	Murray St.	0	0	0	0	0	0	0	0	0	0	0	0	0	0	0	0
Alathea Sellars	Murray St.	Sep. 25, 2016	Murray St.	91	98	96	98	92	92	567	20	95	100	99	97	100	99	590	41
Eric Sloan	Murray St.	Sep. 25, 2016	Murray St.	98	95	97	99	89	89	567	21	94	95	95	96	96	98	574	25
Alex Bapties	UT Martin	Sep. 25, 2016	Murray St.	89	93	92	96	87	88	545	0	94	90	96	95	93	94	562	0
Erin Bell	UT Martin (W)	Sep. 25, 2016	Murray St.	0	0	0	0	0	0	0	0	89	86	90	89	94	95	543	0
Brigitte Curcio	UT Martin	Sep. 25, 2016	Murray St.	92	93	97	95	84	94	555	0	93	93	94	99	97	97	573	0
Andre Delcalzo	UT Martin	Sep. 25, 2016	Murray St.	88	90	93	92	87	85	535	0	95	91	94	93	94	94	561	0
Logan Hunt	UT Martin	Sep. 25, 2016	Murray St.	93	93	94	95	92	93	560	0	96	93	95	92	96	95	567	0
Kaitlin Korinek	UT Martin	Sep. 25, 2016	Murray St.	96	91	96	99	93	93	568	0	96	99	96	96	96	96	579	0
Joe Martin	UT Martin	Sep. 25, 2016	Murray St.	96	98	100	100	93	95	582	0	92	96	100	97	98	98	581	0
Amanda Mayo	UT Martin (W)	Sep. 25, 2016	Murray St.	95	94	93	94	89	87	552	0	83	92	91	90	92	93	541	0
Alex Tamboli	UT Martin	Sep. 25, 2016	Murray St.	93	94	98	97	87	91	560	0	93	93	95	93	95	98	567	0
Ashley Coots	UT Martin (W)	Sep. 25, 2016	Murray St.	92	91	97	95	87	94	556	0	94	96	94	98	97	95	574	0
Lindsey Flint	UT Martin (W)	Sep. 25, 2016	Murray St.	89	90	93	95	85	93	545	0	89	94	95	93	96	93	560	0
Brianna Sawyers	UT Martin (W)	Sep. 25, 2016	Murray St.	94	91	93	92	91	91	552	0	97	94	95	97	96	96	575	0
Alyson Sylvester	UT Martin (W)	Sep. 25, 2016	Murray St.	92	91	95	96	89	88	551	0	91	95	93	91	91	93	554	0
Jennifer Plocinik	UT Martin (W)	Sep. 25, 2016	Murray St.	95	97	96	98	90	91	567	0	89	94	96	96	94	95	564	0
Rachel Benesh	Nevada	Oct. 1, 2016	Nevada Reno	0	0	0	0	0	0	0	0	98	96	99	98	99	100	590	0
Emily Capaul	Nevada	Oct. 1, 2016	Nevada Reno	92	95	96	98	96	92	569	0	0	0	0	0	0	0	0	0
Jared Crews	Nevada	Oct. 1, 2016	Nevada Reno	0	0	0	0	0	0	0	0	0	0	0	0	0	0	0	0
Maneva Gill	Nevada	Oct. 1, 2016	Nevada Reno	0	0	0	0	0	0	0	0	94	94	100	99	94	97	578	0
Sarah Jameson	Nevada	Oct. 1, 2016	Nevada Reno	96	92	99	98	97	95	577	0	99	99	100	97	98	98	591	0
Eli Larimer	Nevada	Oct. 1, 2016	Nevada Reno	93	97	97	98	89	95	569	0	99	97	97	96	97	98	584	0
Justin Nissen	Nevada	Oct. 1, 2016	Nevada Reno	97	95	97	99	95	95	578	0	0	0	0	0	0	0	0	0
Jami Sexton	Nevada	Oct. 1, 2016	Nevada Reno	0	0	0	0	0	0	0	0	0	0	0	0	0	0	0	0
Sara Tashima	Nevada	Oct. 1, 2016	Nevada Reno	0	0	0	0	0	0	0	0	0	0	0	0	0	0	0	0
Mitchell Van Patten	Nevada	Oct. 1, 2016	Nevada Reno	95	97	97	99	93	95	576	0	98	100	97	99	99	98	591	0
Jessica Kinder	UTEP	Oct. 1, 2016	Nevada Reno	0	0	0	0	0	0	0	0	0	0	0	0	0	0	0	0
Abby Monique	UTEP	Oct. 1, 2016	Nevada Reno	97	96	100	98	95	90	576	0	94	94	98	95	95	96	572	0
Maranda Nelson	UTEP	Oct. 1, 2016	Nevada Reno	86	91	96	98	91	86	548	0	94	94	97	95	93	94	567	0
Bailey Powell	UTEP	Oct. 1, 2016	Nevada Reno	95	94	95	99	92	93	568	0	95	94	97	97	99	97	579	0
Mara Rouse	UTEP	Oct. 1, 2016	Nevada Reno	93	94	95	96	85	84	547	0	97	91	97	91	96	96	568	0
Rachael Schoenrock	UTEP	Oct. 1, 2016	Nevada Reno	97	97	99	96	91	90	570	0	94	99	96	97	97	97	580	0
Haylee Schoenrock	UTEP	Oct. 1, 2016	Nevada Reno	93	91	96	99	88	92	559	0	92	98	95	95	98	95	573	0
Monthserrat Serna	UTEP	Oct. 1, 2016	Nevada Reno	0	0	0	0	0	0	0	0	0	0	0	0	0	0	0	0
Allison Auten	Citadel	Oct. 1, 2016	Citadel	88	90	92	93	91	87	541	0	95	93	94	93	97	96	568	0
Matthew Davenport	Citadel	Oct. 1, 2016	Citadel	86	88	97	97	86	82	536	0	95	95	89	92	95	91	557	0
Joseph Ferguson	Citadel	Oct. 1, 2016	Citadel	89	92	96	88	82	85	532	0	94	91	93	95	96	91	560	0
Morgan Long	Citadel	Oct. 1, 2016	Citadel	85	92	92	97	88	85	539	0	98	95	97	95	89	89	563	0
Alexander McAlear	Citadel	Oct. 1, 2016	Citadel	92	90	97	96	92	86	553	0	93	92	96	97	96	95	569	0
Patrick Meyer	Citadel	Oct. 1, 2016	Citadel	89	89	98	92	87	84	539	0	94	93	96	95	91	93	562	0
Richie Parra	Citadel	Oct. 1, 2016	Citadel	87	93	94	93	91	85	543	0	97	96	91	92	95	96	567	0
Colton Poole	Citadel	Oct. 1, 2016	Citadel	92	96	94	94	85	93	554	0	94	98	97	96	96	93	574	0
Tommy Simrill	Citadel	Oct. 1, 2016	Citadel	88	92	95	98	77	83	533	0	94	90	90	95	93	93	555	0
Nicholle Benedict	TCU	Oct. 1, 2016	Citadel	0	0	0	0	0	0	0	0	0	0	0	0	0	0	0	0
Katie Bridges	TCU	Oct. 1, 2016	Citadel	0	0	0	0	0	0	0	0	0	0	0	0	0	0	0	0
Rachel Garner	TCU	Oct. 1, 2016	Citadel	97	100	97	99	97	95	585	0	100	100	100	98	100	99	597	0
Ariana Grabowski	TCU	Oct. 1, 2016	Citadel	99	99	100	98	95	94	585	0	97	97	98	98	98	98	586	0
Emily Haag	TCU	Oct. 1, 2016	Citadel	94	92	98	97	89	88	558	0	97	96	94	97	97	95	576	0
Nicole Hankey	TCU	Oct. 1, 2016	Citadel	96	94	100	99	96	94	579	0	99	99	97	100	99	99	593	0
Rachel Kimbell	TCU	Oct. 1, 2016	Citadel	92	95	98	97	91	93	566	0	97	98	97	96	94	97	579	0
Sally Li	TCU	Oct. 1, 2016	Citadel	96	96	100	99	94	95	580	0	98	97	96	98	97	98	584	0
Casey Lutz	TCU	Oct. 1, 2016	Citadel	99	93	100	100	99	96	587	0	99	100	99	96	99	98	591	0
Mindy Miles	TCU	Oct. 1, 2016	Citadel	96	92	99	100	99	97	583	0	99	100	99	99	100	100	597	0
Catherine Miller	TCU	Oct. 1, 2016	Citadel	96	97	99	97	94	93	576	0	96	99	100	99	97	97	588	0
Meraleigh Randle	TCU	Oct. 1, 2016	Citadel	0	0	0	0	0	0	0	0	0	0	0	0	0	0	0	0
Barrett Ray	TCU	Oct. 1, 2016	Citadel	99	96	100	99	90	91	575	0	99	98	98	97	97	100	589	0
Carli Cline	Citadel (W)	Oct. 1, 2016	Citadel	85	87	89	91	67	73	492	0	86	83	86	81	86	86	508	0
Brandi Duzz	Citadel (W)	Oct. 1, 2016	Citadel	77	87	95	93	75	87	514	0	90	86	96	93	96	91	552	0
Leah Fenwrick-Wallace	Citadel (W)	Oct. 1, 2016	Citadel	85	83	92	95	78	77	510	0	96	91	95	90	90	91	553	0
Shadonna Littlejohn	Citadel (W)	Oct. 1, 2016	Citadel	0	0	0	0	0	0	0	0	0	0	0	0	0	0	0	0
Tierra Price	Citadel (W)	Oct. 1, 2016	Citadel	74	81	80	83	51	64	433	0	76	83	82	83	85	91	500	0
Faith Totherow	Citadel (W)	Oct. 1, 2016	Citadel	80	91	92	93	84	70	510	0	93	85	88	88	92	92	538	0
Raven Wills	Citadel (W)	Oct. 1, 2016	Citadel	74	80	88	88	63	53	446	0	86	83	89	92	82	90	522	0
Angelica Dearaujo	John Jay	Oct. 1, 2016	Navy	85	81	93	87	86	84	516	0	94	95	97	96	90	93	565	0
Lily Graham	John Jay	Oct. 1, 2016	Navy	94	97	97	97	90	91	566	0	97	97	98	93	95	95	575	0
Ronald Kopec	John Jay	Oct. 1, 2016	Navy	80	91	97	96	90	85	539	0	98	96	96	95	96	96	577	0
Ida Sato	John Jay	Oct. 1, 2016	Navy	83	78	89	92	77	78	497	0	91	92	91	95	93	93	555	0
Lucas Figi	Navy	Oct. 1, 2016	Navy	0	0	0	0	0	0	0	0	0	0	0	0	0	0	0	0
Maggie Guetersloh	Navy	Oct. 1, 2016	Navy	91	91	97	95	86	86	546	0	97	97	93	93	92	94	566	0
Amy Hammer	Navy	Oct. 1, 2016	Navy	95	95	99	98	95	95	577	0	96	99	99	99	99	96	588	0
Daniel Jonas	Navy	Oct. 1, 2016	Navy	95	96	98	99	91	94	573	0	96	96	98	99	98	98	585	0
Kestrel Kuhne	Navy	Oct. 1, 2016	Navy	92	99	98	97	82	89	557	0	97	95	92	95	96	97	572	0
Alex Muzzioli	Navy	Oct. 1, 2016	Navy	97	94	96	100	91	90	568	0	97	96	94	92	98	98	575	0
Brandon Pippin	Navy	Oct. 1, 2016	Navy	0	0	0	0	0	0	0	0	96	96	96	98	96	98	580	0
Nash Richardson	Navy	Oct. 1, 2016	Navy	90	94	100	98	96	90	568	0	93	96	95	96	98	94	572	0
Thomas Sarant	Navy	Oct. 1, 2016	Navy	93	93	98	98	93	93	568	0	97	98	98	98	100	100	591	0
Josh Watson	Navy	Oct. 1, 2016	Navy	96	96	98	97	93	85	565	0	97	98	97	97	100	98	587	0
William Davidson	VMI	Oct. 1, 2016	Navy	0	0	0	0	0	0	0	0	0	0	0	0	0	0	0	0
Andrew Hickey	VMI	Oct. 1, 2016	Navy	91	93	97	98	90	89	558	0	96	95	94	94	93	95	567	0
Jacob Hunter	VMI	Oct. 1, 2016	Navy	84	83	86	94	90	90	527	0	95	94	95	97	96	95	572	0
Zachary Johnson	VMI	Oct. 1, 2016	Navy	90	90	97	97	90	89	553	0	93	96	96	94	94	97	570	0
Mathew Lusardi	VMI	Oct. 1, 2016	Navy	93	86	99	97	89	91	555	0	98	93	94	90	95	93	563	0
Chris Milliken	VMI	Oct. 1, 2016	Navy	88	87	92	95	71	80	513	0	94	94	95	89	91	95	558	0
John Pitman	VMI	Oct. 1, 2016	Navy	92	89	100	94	78	87	540	0	94	93	93	91	92	93	556	0
Nick Reynolds	VMI	Oct. 1, 2016	Navy	94	96	95	100	90	89	564	0	95	94	97	96	95	91	568	0
Kelia Aardema	VMI (W)	Oct. 1, 2016	Navy	0	0	0	0	0	0	0	0	0	0	0	0	0	0	0	0
Samantha Alexander	VMI (W)	Oct. 1, 2016	Navy	89	89	96	95	89	91	549	0	95	94	95	95	97	95	571	0
Ellana Avery	VMI (W)	Oct. 1, 2016	Navy	91	90	97	97	80	86	541	0	0	0	0	0	0	0	0	0
Sabrina Bell	VMI (W)	Oct. 1, 2016	Navy	0	0	0	0	0	0	0	0	0	0	0	0	0	0	0	0
Alice Chiu	VMI (W)	Oct. 1, 2016	Navy	93	92	98	98	87	85	553	0	97	91	94	91	92	92	557	0
Jamie Foster	VMI (W)	Oct. 1, 2016	Navy	0	0	0	0	0	0	0	0	0	0	0	0	0	0	0	0
Joelle Henry	VMI (W)	Oct. 1, 2016	Navy	0	0	0	0	0	0	0	0	0	0	0	0	0	0	0	0
Rachel Jankelow	VMI (W)	Oct. 1, 2016	Navy	92	89	96	94	82	82	535	0	92	94	99	93	88	95	561	0
Kerrie Lightfoot	VMI (W)	Oct. 1, 2016	Navy	79	72	89	89	82	83	494	0	94	94	94	93	93	92	560	0
Loyce Lightfoot	VMI (W)	Oct. 1, 2016	Navy	90	93	96	90	85	82	536	0	88	94	91	96	90	87	546	0
Kaitlyn Morrison	VMI (W)	Oct. 1, 2016	Navy	0	0	0	0	0	0	0	0	0	0	0	0	0	0	0	0
Katherine Watson	VMI (W)	Oct. 1, 2016	Navy	83	89	97	96	90	85	540	0	88	93	94	97	93	95	560	0
Eliza Kotowska	John Jay	Oct. 1, 2016	Navy	0	0	0	0	0	0	0	0	0	0	0	0	0	0	0	0
Susana Sanchez	John Jay	Oct. 1, 2016	Navy	48	61	66	73	84	67	399	0	91	86	84	95	88	92	536	0
Marc Suda	John Jay	Oct. 1, 2016	Navy	91	82	91	91	76	66	497	0	87	83	88	85	87	86	516	0
Deanna Binnie	Ohio State	Oct. 2, 2016	West Virginia	97	98	98	98	93	90	574	28	99	97	98	96	95	94	579	0
Josh Black	Ohio State	Oct. 2, 2016	West Virginia	94	98	97	97	94	95	575	20	98	99	99	98	95	98	587	0
Jacob Buchanan	Ohio State	Oct. 2, 2016	West Virginia	98	97	99	99	93	92	578	28	99	98	97	100	100	99	593	0
Drew Cheezum	Ohio State	Oct. 2, 2016	West Virginia	97	95	98	100	95	95	580	25	97	100	99	96	99	99	590	0
Anthony Cuozzo	Ohio State	Oct. 2, 2016	West Virginia	0	0	0	0	0	0	0	0	0	0	0	0	0	0	0	0
Kendal Elder	Ohio State	Oct. 2, 2016	West Virginia	95	98	96	98	91	92	570	29	97	98	97	95	99	96	582	0
Alli Kissell	Ohio State	Oct. 2, 2016	West Virginia	98	96	97	94	95	95	575	24	94	95	98	95	99	98	579	0
Mark Matheny	Ohio State	Oct. 2, 2016	West Virginia	94	96	99	98	92	95	574	21	98	97	97	100	99	96	587	0
Patrick Sardo	Ohio State	Oct. 2, 2016	West Virginia	0	0	0	0	0	0	0	0	0	0	0	0	0	0	0	0
Michael Steinel	Ohio State	Oct. 2, 2016	West Virginia	100	96	100	100	94	94	584	33	98	99	99	99	97	99	591	0
Chrissy Thomas	Ohio State	Oct. 2, 2016	West Virginia	88	92	99	97	93	94	563	19	96	96	97	96	94	96	575	0
Rhiann Travis	Ohio State	Oct. 2, 2016	West Virginia	96	94	100	100	94	95	579	30	100	98	98	99	98	99	592	0
Bailey Urbach	Ohio State	Oct. 2, 2016	West Virginia	93	92	98	97	91	93	564	20	90	96	98	96	95	95	570	0
Brendan Whitaker	Ohio State	Oct. 2, 2016	West Virginia	96	95	98	100	95	89	573	27	95	96	97	97	96	96	577	0
Quintin Wotring	Ohio State	Oct. 2, 2016	West Virginia	97	96	98	99	94	97	581	30	95	98	98	99	98	99	587	0
Jack Anderson	West Virginia	Oct. 2, 2016	West Virginia	90	96	96	96	95	94	567	24	97	97	97	98	98	97	584	0
Will Anti	West Virginia	Oct. 2, 2016	West Virginia	93	96	100	98	98	98	583	30	94	98	98	98	99	99	586	0
Milica Babic	West Virginia	Oct. 2, 2016	West Virginia	95	92	99	99	98	95	578	31	99	98	97	98	99	99	590	0
Noah Barker	West Virginia	Oct. 2, 2016	West Virginia	0	0	0	0	0	0	0	0	0	0	0	0	0	0	0	0
Elizabeth Gratz	West Virginia	Oct. 2, 2016	West Virginia	96	98	100	99	97	93	583	31	99	100	99	99	97	98	592	0
Jean-Pierre Lucas	West Virginia	Oct. 2, 2016	West Virginia	96	100	100	99	97	96	588	35	98	99	97	97	100	98	589	0
Morgan Phillips	West Virginia	Oct. 2, 2016	West Virginia	95	94	97	99	92	93	570	18	96	96	96	99	96	98	581	0
Ginny Thrasher	West Virginia	Oct. 2, 2016	West Virginia	96	99	100	100	99	100	594	41	98	98	100	100	100	99	595	0
Melissa Brizzi	Coast Guard	Oct. 8, 2016	Navy	81	90	94	95	74	83	517	0	88	85	90	89	88	88	528	0
Joseph Busching	Coast Guard	Oct. 8, 2016	Navy	0	0	0	0	0	0	0	0	0	0	0	0	0	0	0	0
Jacob Dupree	Coast Guard	Oct. 8, 2016	Navy	87	92	96	98	70	83	526	0	87	92	91	93	92	90	545	0
Randall Ford	Coast Guard	Oct. 8, 2016	Navy	87	92	92	94	91	83	539	0	91	96	91	93	92	92	555	0
Marshall Grant	Coast Guard	Oct. 8, 2016	Navy	0	0	0	0	0	0	0	0	0	0	0	0	0	0	0	0
Alexandria Harrington	Coast Guard	Oct. 8, 2016	Navy	87	80	95	99	92	90	543	0	98	97	94	95	97	96	577	0
Anthony Lee	Coast Guard	Oct. 8, 2016	Navy	0	0	0	0	0	0	0	0	0	0	0	0	0	0	0	0
Dylan Lorence	Coast Guard	Oct. 8, 2016	Navy	90	93	97	97	80	84	541	0	86	95	91	90	93	92	547	0
Kaden Nichols	Coast Guard	Oct. 8, 2016	Navy	0	0	0	0	0	0	0	0	0	0	0	0	0	0	0	0
Nicholas Paisker	Coast Guard	Oct. 8, 2016	Navy	93	93	98	97	88	93	562	0	96	97	95	96	95	93	572	93
Paul Raynolds	Coast Guard	Oct. 8, 2016	Navy	0	0	0	0	0	0	0	0	0	0	0	0	0	0	0	0
David Rose	Coast Guard	Oct. 8, 2016	Navy	0	0	0	0	0	0	0	0	0	0	0	0	0	0	0	0
Alaric Stone	Coast Guard	Oct. 8, 2016	Navy	0	0	0	0	0	0	0	0	0	0	0	0	0	0	0	0
Nyjah Turner	Coast Guard	Oct. 8, 2016	Navy	0	0	0	0	0	0	0	0	0	0	0	0	0	0	0	0
Lucas Figi	Navy	Oct. 8, 2016	Navy	0	0	0	0	0	0	0	0	0	0	0	0	0	0	0	0
Maggie Guetersloh	Navy	Oct. 8, 2016	Navy	91	93	95	95	93	86	553	0	95	98	98	96	92	94	573	0
Amy Hammer	Navy	Oct. 8, 2016	Navy	94	97	96	97	97	96	577	0	97	95	98	100	99	98	587	0
Daniel Jonas	Navy	Oct. 8, 2016	Navy	93	95	96	99	96	91	570	0	97	96	99	98	97	98	585	0
Kestrel Kuhne	Navy	Oct. 8, 2016	Navy	94	94	97	95	89	89	558	0	94	97	94	96	97	97	575	0
Alex Muzzioli	Navy	Oct. 8, 2016	Navy	95	96	99	99	92	94	575	0	94	95	98	97	98	97	579	0
Brandon Pippin	Navy	Oct. 8, 2016	Navy	0	0	0	0	0	0	0	0	97	93	95	96	96	97	574	0
Nash Richardson	Navy	Oct. 8, 2016	Navy	96	94	100	99	93	90	572	0	94	94	94	95	92	98	567	0
Thomas Sarant	Navy	Oct. 8, 2016	Navy	95	92	98	99	96	92	572	0	98	98	96	98	96	94	580	0
Josh Watson	Navy	Oct. 8, 2016	Navy	95	98	98	100	90	92	573	0	94	97	96	95	97	99	578	0
Rachel Hubal	USciences	Oct. 8, 2016	Navy	83	84	94	96	75	85	517	0	77	79	83	77	69	80	465	0
Angela Kang	USciences	Oct. 8, 2016	Navy	87	90	91	91	84	79	522	0	81	78	92	84	87	93	515	0
Brittany Mahoney	USciences	Oct. 8, 2016	Navy	0	0	0	0	0	0	0	0	0	0	0	0	0	0	0	0
Chris Makosiej	USciences	Oct. 8, 2016	Navy	62	70	88	86	57	79	442	0	81	77	83	86	74	82	483	0
Nick Makosiej	USciences	Oct. 8, 2016	Navy	0	0	0	0	0	0	0	0	0	0	0	0	0	0	0	0
Thomas Nelligan	USciences	Oct. 8, 2016	Navy	0	0	0	0	0	0	0	0	0	0	0	0	0	0	0	0
Matt Popowicz	USciences	Oct. 8, 2016	Navy	82	90	96	95	87	73	523	0	87	86	90	92	85	92	532	0
Andrej Quatrone	USciences	Oct. 8, 2016	Navy	83	81	89	92	66	76	487	0	79	83	91	77	80	79	489	0
Sarah Schnupp	USciences	Oct. 8, 2016	Navy	91	93	98	97	91	92	562	0	90	95	96	93	100	96	570	0
Lauren Stabler	USciences	Oct. 8, 2016	Navy	80	80	89	93	83	74	499	0	93	89	89	86	91	92	540	0
Christina Tipton	USciences	Oct. 8, 2016	Navy	0	0	0	0	0	0	0	0	0	0	0	0	0	0	0	0
Allie Tuman	USciences	Oct. 8, 2016	Navy	83	82	93	89	78	80	505	0	91	90	85	90	90	84	530	0
Anita Varkey	USciences	Oct. 8, 2016	Navy	0	0	0	0	0	0	0	0	0	0	0	0	0	0	0	0
Andrew Visconti	USciences	Oct. 8, 2016	Navy	92	93	98	96	82	86	547	0	93	92	93	95	90	89	552	0
Nick Zsoldos	USciences	Oct. 8, 2016	Navy	95	93	92	95	84	80	539	0	86	86	88	84	91	90	525	0
Kealie Engels	Wofford	Oct. 8, 2016	Wofford	0	0	0	0	0	0	0	0	0	0	0	0	0	0	0	0
Seth Flanagan	Wofford	Oct. 8, 2016	Wofford	0	0	0	0	0	0	0	0	94	90	92	90	91	89	546	0
Cierra Holcombe	Wofford	Oct. 8, 2016	Wofford	0	0	0	0	0	0	0	0	94	94	96	95	93	94	566	0
Carson Howell	Wofford	Oct. 8, 2016	Wofford	0	0	0	0	0	0	0	0	81	86	80	85	79	75	486	0
Nicholas Hunter	Wofford	Oct. 8, 2016	Wofford	0	0	0	0	0	0	0	0	91	93	87	95	96	92	554	0
Zachry Hunter	Wofford	Oct. 8, 2016	Wofford	0	0	0	0	0	0	0	0	80	89	80	81	85	82	497	0
Reid Schuster	Wofford	Oct. 8, 2016	Wofford	0	0	0	0	0	0	0	0	85	85	89	85	89	91	524	0
Sarah Banks	Alabama Birmingham	Oct. 8, 2016	Wofford	0	0	0	0	0	0	0	0	96	93	95	93	93	94	564	0
Steven Bugg	Alabama Birmingham	Oct. 8, 2016	Wofford	0	0	0	0	0	0	0	0	0	0	0	0	0	0	0	0
Selina Curren	Alabama Birmingham	Oct. 8, 2016	Wofford	0	0	0	0	0	0	0	0	89	95	91	87	93	92	547	0
Lindsey Hill	Alabama Birmingham	Oct. 8, 2016	Wofford	0	0	0	0	0	0	0	0	0	0	0	0	0	0	0	0
Isaac King	Alabama Birmingham	Oct. 8, 2016	Wofford	0	0	0	0	0	0	0	0	0	0	0	0	0	0	0	0
Kristie Lloyd	Alabama Birmingham	Oct. 8, 2016	Wofford	0	0	0	0	0	0	0	0	92	94	91	97	90	88	552	0
Logan Short	Alabama Birmingham	Oct. 8, 2016	Wofford	0	0	0	0	0	0	0	0	0	0	0	0	0	0	0	0
Mallory Sisk	Alabama Birmingham	Oct. 8, 2016	Wofford	0	0	0	0	0	0	0	0	0	0	0	0	0	0	0	0
Micah Smith	Alabama Birmingham	Oct. 8, 2016	Wofford	0	0	0	0	0	0	0	0	0	0	0	0	0	0	0	0
Emily Stover	Alabama Birmingham	Oct. 8, 2016	Wofford	0	0	0	0	0	0	0	0	86	87	87	90	94	86	530	0
Ella Von Canon	Alabama Birmingham	Oct. 8, 2016	Wofford	0	0	0	0	0	0	0	0	0	0	0	0	0	0	0	0
Lilly Vonderau	Alabama Birmingham	Oct. 8, 2016	Wofford	0	0	0	0	0	0	0	0	92	95	96	95	97	97	572	0
Lauryn Cinadr	Akron	Oct. 8, 2016	Akron	92	91	97	94	90	79	543	14	95	95	96	96	93	95	570	0
Alex Fedorko	Akron	Oct. 8, 2016	Akron	93	91	92	96	91	86	549	14	0	0	0	0	0	0	0	0
Sydney Goldschlag	Akron	Oct. 8, 2016	Akron	94	94	93	98	81	86	546	13	97	96	98	92	96	93	572	0
Rebecca Green	Akron	Oct. 8, 2016	Akron	93	88	91	96	89	89	546	14	98	96	95	98	93	94	574	0
Julia Hatch	Akron	Oct. 8, 2016	Akron	95	97	98	98	93	94	575	26	97	95	98	92	98	96	576	0
Anthony Jackson	Akron	Oct. 8, 2016	Akron	91	94	100	96	92	90	563	26	95	98	97	98	96	96	580	0
Kera Kaufman	Akron	Oct. 8, 2016	Akron	91	89	99	97	86	93	555	21	96	93	95	99	92	95	570	0
Joshua Kovach	Akron	Oct. 8, 2016	Akron	88	83	95	96	91	91	544	13	99	99	98	93	98	97	584	0
Caleb Lloyd	Akron	Oct. 8, 2016	Akron	96	97	98	98	90	93	572	33	96	95	97	98	97	98	581	0
Danielle Makucevich	Akron	Oct. 8, 2016	Akron	93	93	97	90	95	87	555	17	0	0	0	0	0	0	0	0
Kris Mantel	Akron	Oct. 8, 2016	Akron	93	92	96	96	83	82	542	16	92	90	98	97	95	95	567	0
Brent Morgan	Akron	Oct. 8, 2016	Akron	0	0	0	0	0	0	0	0	92	95	92	94	95	93	561	0
Connor O'Mara	Akron	Oct. 8, 2016	Akron	92	92	100	99	95	94	572	27	99	97	97	99	96	96	584	0
Marlee Reynolds	Akron	Oct. 8, 2016	Akron	0	0	0	0	0	0	0	0	0	0	0	0	0	0	0	0
Sean Roehrs	Akron	Oct. 8, 2016	Akron	95	93	98	93	85	92	556	17	95	94	93	98	89	90	559	0
Zach Strohl	Akron	Oct. 8, 2016	Akron	94	92	99	99	93	90	567	21	94	96	98	98	98	97	581	0
Cierra Terrizzi	Akron	Oct. 8, 2016	Akron	96	89	96	98	93	90	562	16	97	96	97	98	94	91	573	0
Angelica Dearaujo	John Jay	Oct. 8, 2016	Akron	84	84	91	93	90	87	529	8	94	94	94	94	93	94	563	0
Lily Graham	John Jay	Oct. 8, 2016	Akron	96	90	98	96	94	85	559	23	93	97	98	98	96	96	578	0
Ronald Kopec	John Jay	Oct. 8, 2016	Akron	0	0	0	0	0	0	0	0	0	0	0	0	0	0	0	0
Ida Sato	John Jay	Oct. 8, 2016	Akron	82	75	87	88	88	79	499	7	90	94	86	89	87	89	535	0
Eliza Kotowska	John Jay	Oct. 8, 2016	Akron	0	0	0	0	0	0	0	0	0	0	0	0	0	0	0	0
Susana Sanchez	John Jay	Oct. 8, 2016	Akron	67	75	79	79	69	60	429	3	84	89	85	87	84	86	515	0
Marc Suda	John Jay	Oct. 8, 2016	Akron	88	88	95	92	73	77	513	9	85	88	84	85	77	87	506	0
Spencer Brandon	Air Force	Oct. 8, 2016	Alaska Fairbanks	92	94	98	100	97	98	579	26	97	99	100	99	95	100	590	39
Spencer Cap	Air Force	Oct. 8, 2016	Alaska Fairbanks	97	98	98	98	92	94	577	27	98	97	98	99	98	99	589	39
Kyle Cox	Air Force	Oct. 8, 2016	Alaska Fairbanks	0	0	0	0	0	0	0	0	0	0	0	0	0	0	0	0
Ryan Jacobs	Air Force	Oct. 8, 2016	Alaska Fairbanks	98	98	98	97	98	98	587	34	99	98	100	100	100	98	595	50
Noah Kwock	Air Force	Oct. 8, 2016	Alaska Fairbanks	0	0	0	0	0	0	0	0	0	0	0	0	0	0	0	0
Nick Learn	Air Force	Oct. 8, 2016	Alaska Fairbanks	94	95	98	99	92	95	573	21	97	96	98	98	100	98	587	42
Logan Ogden	Air Force	Oct. 8, 2016	Alaska Fairbanks	94	99	98	99	96	96	582	28	100	98	97	99	98	100	592	44
Mary Simonton	Air Force	Oct. 8, 2016	Alaska Fairbanks	0	0	0	0	0	0	0	0	0	0	0	0	0	0	0	0
Anna Weilbacher	Air Force	Oct. 8, 2016	Alaska Fairbanks	96	94	100	100	96	96	582	30	99	98	99	99	99	99	593	47
Soren Butler	Alaska Fairbanks	Oct. 8, 2016	Alaska Fairbanks	95	95	99	99	92	95	575	25	99	100	98	99	99	99	594	46
Liam Eberhart	Alaska Fairbanks	Oct. 8, 2016	Alaska Fairbanks	95	97	96	100	95	92	575	26	0	0	0	0	0	0	0	0
Amy Gentry	Alaska Fairbanks	Oct. 8, 2016	Alaska Fairbanks	98	94	98	95	95	94	574	28	96	98	97	97	98	98	584	35
Luke Johnson	Alaska Fairbanks	Oct. 8, 2016	Alaska Fairbanks	96	98	99	99	91	95	578	23	98	99	99	98	97	95	586	39
Sagen Maddalena	Alaska Fairbanks	Oct. 8, 2016	Alaska Fairbanks	98	98	100	99	92	96	583	35	100	99	100	100	99	100	598	52
Grace Nelson	Alaska Fairbanks	Oct. 8, 2016	Alaska Fairbanks	0	0	0	0	0	0	0	0	92	99	97	97	96	94	575	31
JT Schnering	Alaska Fairbanks	Oct. 8, 2016	Alaska Fairbanks	97	96	97	99	96	92	577	27	97	97	98	97	100	99	588	39
Robert Scott	Alaska Fairbanks	Oct. 8, 2016	Alaska Fairbanks	95	96	98	97	90	96	572	24	99	95	98	97	98	95	582	36
Nathan Taylor	Alaska Fairbanks	Oct. 8, 2016	Alaska Fairbanks	92	96	98	96	90	93	565	20	97	95	98	97	97	96	580	31
Nicholle Benedict	TCU	Oct. 8, 2016	Alaska Fairbanks	0	0	0	0	0	0	0	0	0	0	0	0	0	0	0	0
Katie Bridges	TCU	Oct. 8, 2016	Alaska Fairbanks	0	0	0	0	0	0	0	0	0	0	0	0	0	0	0	0
Rachel Garner	TCU	Oct. 8, 2016	Alaska Fairbanks	95	99	99	100	97	95	585	27	96	100	99	100	99	99	593	41
Ariana Grabowski	TCU	Oct. 8, 2016	Alaska Fairbanks	98	100	100	100	93	96	587	36	98	96	98	100	99	98	589	40
Emily Haag	TCU	Oct. 8, 2016	Alaska Fairbanks	0	0	0	0	0	0	0	0	99	97	99	98	98	97	588	40
Nicole Hankey	TCU	Oct. 8, 2016	Alaska Fairbanks	97	96	99	98	92	97	579	22	99	96	97	97	99	98	586	37
Rachel Kimbell	TCU	Oct. 8, 2016	Alaska Fairbanks	97	94	98	99	92	92	572	26	0	0	0	0	0	0	0	0
Sally Li	TCU	Oct. 8, 2016	Alaska Fairbanks	97	94	98	98	96	96	579	23	100	98	100	98	99	99	594	49
Casey Lutz	TCU	Oct. 8, 2016	Alaska Fairbanks	94	98	98	99	95	99	583	30	97	99	99	98	97	99	589	41
Mindy Miles	TCU	Oct. 8, 2016	Alaska Fairbanks	95	90	98	99	95	92	569	24	100	100	100	99	100	100	599	55
Catherine Miller	TCU	Oct. 8, 2016	Alaska Fairbanks	95	95	98	99	95	93	575	19	99	98	100	99	99	98	593	45
Meraleigh Randle	TCU	Oct. 8, 2016	Alaska Fairbanks	0	0	0	0	0	0	0	0	0	0	0	0	0	0	0	0
Barrett Ray	TCU	Oct. 8, 2016	Alaska Fairbanks	96	97	99	100	92	89	573	28	99	99	97	98	100	98	591	45
Rachel Benesh	Nevada	Oct. 8, 2016	UTEP	95	96	97	95	91	96	570	0	95	98	98	96	95	98	580	0
Emily Capaul	Nevada	Oct. 8, 2016	UTEP	92	95	99	99	90	91	566	0	98	98	98	98	100	99	591	0
Jared Crews	Nevada	Oct. 8, 2016	UTEP	0	0	0	0	0	0	0	0	0	0	0	0	0	0	0	0
Maneva Gill	Nevada	Oct. 8, 2016	UTEP	0	0	0	0	0	0	0	0	0	0	0	0	0	0	0	0
Sarah Jameson	Nevada	Oct. 8, 2016	UTEP	94	93	99	99	94	94	573	0	95	100	95	96	99	100	585	0
Eli Larimer	Nevada	Oct. 8, 2016	UTEP	89	93	100	99	95	92	568	0	96	99	98	100	96	99	588	0
Justin Nissen	Nevada	Oct. 8, 2016	UTEP	95	94	98	95	94	93	569	0	96	99	97	98	98	100	588	0
Jami Sexton	Nevada	Oct. 8, 2016	UTEP	0	0	0	0	0	0	0	0	0	0	0	0	0	0	0	0
Sara Tashima	Nevada	Oct. 8, 2016	UTEP	0	0	0	0	0	0	0	0	0	0	0	0	0	0	0	0
Mitchell Van Patten	Nevada	Oct. 8, 2016	UTEP	97	94	100	99	95	95	580	0	96	98	99	100	97	98	588	0
Jessica Kinder	UTEP	Oct. 8, 2016	UTEP	0	0	0	0	0	0	0	0	98	97	99	98	97	99	588	0
Abby Monique	UTEP	Oct. 8, 2016	UTEP	97	94	99	96	90	93	569	0	93	98	99	96	99	98	583	0
Maranda Nelson	UTEP	Oct. 8, 2016	UTEP	90	96	97	98	90	86	557	0	97	95	92	94	93	93	564	0
Bailey Powell	UTEP	Oct. 8, 2016	UTEP	95	93	90	99	89	94	560	0	97	98	97	98	100	98	588	0
Mara Rouse	UTEP	Oct. 8, 2016	UTEP	93	93	98	92	93	85	554	0	95	95	95	96	95	95	571	0
Rachael Schoenrock	UTEP	Oct. 8, 2016	UTEP	95	97	98	100	95	95	580	0	98	99	97	98	97	100	589	0
Haylee Schoenrock	UTEP	Oct. 8, 2016	UTEP	95	92	94	94	90	95	560	0	96	96	94	96	96	95	573	0
Monthserrat Serna	UTEP	Oct. 8, 2016	UTEP	0	0	0	0	0	0	0	0	96	94	97	93	94	93	567	0
Billy Azzinaro	Kentucky	Oct. 8, 2016	Kentucky	0	0	0	0	0	0	0	0	0	0	0	0	0	0	0	0
Jenna Bethea	Kentucky	Oct. 8, 2016	Kentucky	94	92	99	98	89	95	567	0	96	98	99	98	98	99	588	0
Hanna Carr	Kentucky	Oct. 8, 2016	Kentucky	0	0	0	0	0	0	0	0	0	0	0	0	0	0	0	0
Morgan Duerr	Kentucky	Oct. 8, 2016	Kentucky	94	86	97	98	85	93	553	0	95	94	97	94	95	96	571	0
Ian Foos	Kentucky	Oct. 8, 2016	Kentucky	92	97	99	96	91	96	571	0	97	97	98	97	98	99	586	0
Carmen Fry	Kentucky	Oct. 8, 2016	Kentucky	96	97	99	97	92	91	572	0	97	97	98	99	96	97	584	0
Heather Kirby	Kentucky	Oct. 8, 2016	Kentucky	0	0	0	0	0	0	0	0	0	0	0	0	0	0	0	0
Sonya May	Kentucky	Oct. 8, 2016	Kentucky	0	0	0	0	0	0	0	0	0	0	0	0	0	0	0	0
Andrew Miller	Kentucky	Oct. 8, 2016	Kentucky	92	91	96	100	94	91	564	0	96	96	96	97	90	95	570	0
Cathryn Papasodora	Kentucky	Oct. 8, 2016	Kentucky	0	0	0	0	0	0	0	0	0	0	0	0	0	0	0	0
Jason Scharbel	Kentucky	Oct. 8, 2016	Kentucky	98	95	100	100	91	95	579	0	98	94	100	93	98	97	580	0
Jason Spaude	Kentucky	Oct. 8, 2016	Kentucky	0	0	0	0	0	0	0	0	0	0	0	0	0	0	0	0
Andrew Abernathy	North Georgia	Oct. 8, 2016	Kentucky	91	94	93	98	94	91	561	0	97	96	94	97	92	97	573	0
Eric Azotea	North Georgia	Oct. 8, 2016	Kentucky	0	0	0	0	0	0	0	0	0	0	0	0	0	0	0	0
Ruthanne Conner	North Georgia	Oct. 8, 2016	Kentucky	90	95	98	100	92	95	570	0	97	98	99	97	96	96	583	0
Lucas Gilliland	North Georgia	Oct. 8, 2016	Kentucky	89	91	95	98	91	88	552	0	96	96	97	96	96	97	578	0
Maddie Godwin	North Georgia	Oct. 8, 2016	Kentucky	0	0	0	0	0	0	0	0	0	0	0	0	0	0	0	0
Hannah Peevy	North Georgia	Oct. 8, 2016	Kentucky	0	0	0	0	0	0	0	0	0	0	0	0	0	0	0	0
Jared Rice	North Georgia	Oct. 8, 2016	Kentucky	90	96	97	98	96	92	569	0	99	94	97	98	98	96	582	0
Tobin Sanctuary	North Georgia	Oct. 8, 2016	Kentucky	94	94	98	97	91	85	559	0	99	98	95	92	95	97	576	0
Brianna Shaw	North Georgia	Oct. 8, 2016	Kentucky	91	91	100	96	87	91	556	0	92	98	95	93	98	93	569	93
Dakota Spivey	North Georgia	Oct. 8, 2016	Kentucky	97	93	100	97	92	93	572	0	100	100	95	100	99	98	592	0
David Turner	North Georgia	Oct. 8, 2016	Kentucky	0	0	0	0	0	0	0	0	0	0	0	0	0	0	0	0
Melissa Brizzi	Coast Guard	Oct. 9, 2016	Navy	90	90	96	98	72	68	514	0	80	94	94	87	86	89	530	0
Joseph Busching	Coast Guard	Oct. 9, 2016	Navy	0	0	0	0	0	0	0	0	0	0	0	0	0	0	0	0
Jacob Dupree	Coast Guard	Oct. 9, 2016	Navy	90	88	93	97	73	68	509	0	90	95	93	96	95	91	560	0
Randall Ford	Coast Guard	Oct. 9, 2016	Navy	80	76	94	96	83	78	507	0	92	90	96	94	93	92	557	0
Marshall Grant	Coast Guard	Oct. 9, 2016	Navy	0	0	0	0	0	0	0	0	0	0	0	0	0	0	0	0
Alexandria Harrington	Coast Guard	Oct. 9, 2016	Navy	89	87	98	98	89	89	550	0	96	95	93	95	95	95	569	0
Anthony Lee	Coast Guard	Oct. 9, 2016	Navy	0	0	0	0	0	0	0	0	0	0	0	0	0	0	0	0
Dylan Lorence	Coast Guard	Oct. 9, 2016	Navy	93	90	97	95	82	90	547	0	87	87	92	87	90	93	536	0
Kaden Nichols	Coast Guard	Oct. 9, 2016	Navy	0	0	0	0	0	0	0	0	0	0	0	0	0	0	0	0
Nicholas Paisker	Coast Guard	Oct. 9, 2016	Navy	96	93	98	94	91	90	562	0	93	96	96	93	94	94	566	0
Paul Raynolds	Coast Guard	Oct. 9, 2016	Navy	0	0	0	0	0	0	0	0	0	0	0	0	0	0	0	0
David Rose	Coast Guard	Oct. 9, 2016	Navy	0	0	0	0	0	0	0	0	0	0	0	0	0	0	0	0
Alaric Stone	Coast Guard	Oct. 9, 2016	Navy	0	0	0	0	0	0	0	0	0	0	0	0	0	0	0	0
Nyjah Turner	Coast Guard	Oct. 9, 2016	Navy	0	0	0	0	0	0	0	0	0	0	0	0	0	0	0	0
Lucas Figi	Navy	Oct. 9, 2016	Navy	0	0	0	0	0	0	0	0	0	0	0	0	0	0	0	0
Maggie Guetersloh	Navy	Oct. 9, 2016	Navy	93	93	93	96	92	90	557	0	96	94	96	96	95	94	571	0
Amy Hammer	Navy	Oct. 9, 2016	Navy	97	94	99	97	90	97	574	0	96	97	99	98	98	98	586	0
Daniel Jonas	Navy	Oct. 9, 2016	Navy	96	97	98	99	97	95	582	0	96	99	100	99	97	96	587	0
Kestrel Kuhne	Navy	Oct. 9, 2016	Navy	91	95	97	98	96	91	568	0	94	94	95	95	94	95	567	0
Alex Muzzioli	Navy	Oct. 9, 2016	Navy	94	99	96	98	97	91	575	0	97	99	97	97	96	97	583	0
Brandon Pippin	Navy	Oct. 9, 2016	Navy	0	0	0	0	0	0	0	0	95	96	96	97	98	96	578	0
Nash Richardson	Navy	Oct. 9, 2016	Navy	97	93	99	99	95	89	572	0	91	95	97	93	97	98	571	0
Thomas Sarant	Navy	Oct. 9, 2016	Navy	95	96	97	99	96	95	578	0	96	100	97	97	96	97	583	0
Josh Watson	Navy	Oct. 9, 2016	Navy	96	97	96	97	94	96	576	0	98	97	99	97	97	97	585	0
Jack Berhorst	Memphis	Oct. 9, 2016	Navy	99	96	99	100	93	96	583	0	94	96	96	96	95	98	575	0
Haylea Broughton	Memphis	Oct. 9, 2016	Navy	92	94	97	97	97	94	571	0	99	99	100	99	99	99	595	0
Levi Clark	Memphis	Oct. 9, 2016	Navy	97	98	99	99	94	93	580	0	98	98	99	97	99	97	588	0
Leighton Dempster	Memphis	Oct. 9, 2016	Navy	96	97	97	99	91	97	577	0	99	95	100	100	97	96	587	0
Makennon Doran	Memphis	Oct. 9, 2016	Navy	95	94	99	97	86	86	557	0	96	95	99	96	98	95	579	0
Amberlie Ezell	Memphis	Oct. 9, 2016	Navy	0	0	0	0	0	0	0	0	0	0	0	0	0	0	0	0
Amy Fister	Memphis	Oct. 9, 2016	Navy	98	95	100	100	94	90	577	0	97	97	97	100	97	100	588	0
Eli Rischling	Memphis	Oct. 9, 2016	Navy	90	91	99	98	87	91	556	0	95	92	99	96	96	96	574	0
Abby Votava	Memphis	Oct. 9, 2016	Navy	0	0	0	0	0	0	0	0	0	0	0	0	0	0	0	0
Nathan Brewer	Army	Oct. 10, 2016	Army	99	97	98	99	93	93	579	28	98	94	98	100	97	98	585	39
Emiliano Concha-Toro	Army	Oct. 10, 2016	Army	91	91	100	95	93	92	562	18	99	96	96	95	95	97	578	32
Ethan Cook	Army	Oct. 10, 2016	Army	93	90	99	95	94	92	563	19	95	93	95	94	97	91	565	24
Danielle Cuomo	Army	Oct. 10, 2016	Army	96	99	98	100	95	83	571	29	98	99	97	95	97	99	585	35
Maggie Ehmann	Army	Oct. 10, 2016	Army	91	95	99	99	88	92	564	19	96	96	97	97	97	100	583	33
Maddy Erikson	Army	Oct. 10, 2016	Army	91	88	98	98	91	93	559	24	98	96	98	96	99	96	583	39
Mike Garner	Army	Oct. 10, 2016	Army	98	93	99	99	94	92	575	23	97	99	98	97	95	95	581	33
Nick Kanellis	Army	Oct. 10, 2016	Army	89	88	99	99	92	93	560	20	98	100	96	96	95	98	583	30
Marvin Lewis	Army	Oct. 10, 2016	Army	93	95	97	100	93	96	574	25	98	97	96	100	100	98	589	39
Rhianna Lichtenthal	Army	Oct. 10, 2016	Army	90	86	96	99	88	92	551	14	95	97	95	96	98	97	578	26
Libby Mostert	Army	Oct. 10, 2016	Army	91	93	98	98	93	91	564	23	92	98	98	96	95	97	576	29
Sarah Nakata	Army	Oct. 10, 2016	Army	0	0	0	0	0	0	0	0	98	98	98	97	97	97	585	38
Payne Nunn	Army	Oct. 10, 2016	Army	95	93	94	97	95	94	568	22	96	94	97	98	95	97	577	28
Allen Solida	Army	Oct. 10, 2016	Army	95	92	100	97	97	95	576	20	97	98	97	94	98	97	581	37
Andrew Solomonides	Army	Oct. 10, 2016	Army	94	92	99	96	90	89	560	19	95	95	98	95	94	96	573	26
William Caruso	MIT	Oct. 10, 2016	Army	77	81	89	81	68	80	476	4	84	80	89	79	90	85	507	6
Efraim Helman	MIT	Oct. 10, 2016	Army	0	0	0	0	0	0	0	0	0	0	0	0	0	0	0	0
Yaakov Helman	MIT	Oct. 10, 2016	Army	0	0	0	0	0	0	0	0	0	0	0	0	0	0	0	0
Jesus Herrera	MIT	Oct. 10, 2016	Army	0	0	0	0	0	0	0	0	0	0	0	0	0	0	0	0
Alexander Laiman	MIT	Oct. 10, 2016	Army	0	0	0	0	0	0	0	0	0	0	0	0	0	0	0	0
Gregory Lee	MIT	Oct. 10, 2016	Army	82	89	92	95	83	84	525	8	91	91	94	94	90	86	546	23
Kelly Mathesius	MIT	Oct. 10, 2016	Army	90	87	92	93	89	90	541	10	93	95	92	95	94	94	563	22
Elijah Miller	MIT	Oct. 10, 2016	Army	0	0	0	0	0	0	0	0	0	0	0	0	0	0	0	0
Dylan Modesitt	MIT	Oct. 10, 2016	Army	0	0	0	0	0	0	0	0	0	0	0	0	0	0	0	0
Kevin Ng	MIT	Oct. 10, 2016	Army	89	84	95	95	75	74	512	8	92	94	93	95	92	89	555	15
Alex Pacheco	MIT	Oct. 10, 2016	Army	0	0	0	0	0	0	0	0	0	0	0	0	0	0	0	0
Kevin Petrovic	MIT	Oct. 10, 2016	Army	0	0	0	0	0	0	0	0	0	0	0	0	0	0	0	0
Thomas Rick	MIT	Oct. 10, 2016	Army	80	80	87	89	64	63	463	6	0	0	0	0	0	0	0	0
Joel Solis	MIT	Oct. 10, 2016	Army	0	0	0	0	0	0	0	0	84	84	82	82	86	87	505	5
Jack Berhorst	Memphis	Oct. 10, 2016	Army	94	94	100	100	90	93	571	22	97	95	98	97	98	96	581	34
Haylea Broughton	Memphis	Oct. 10, 2016	Army	91	95	97	100	95	95	573	27	96	97	95	99	98	98	583	29
Levi Clark	Memphis	Oct. 10, 2016	Army	98	97	97	100	94	96	582	29	99	97	99	95	98	99	587	36
Leighton Dempster	Memphis	Oct. 10, 2016	Army	95	97	96	96	90	93	567	19	99	99	97	100	98	97	590	40
Makennon Doran	Memphis	Oct. 10, 2016	Army	92	94	98	98	91	85	558	13	97	94	97	97	96	95	576	24
Amberlie Ezell	Memphis	Oct. 10, 2016	Army	0	0	0	0	0	0	0	0	0	0	0	0	0	0	0	0
Amy Fister	Memphis	Oct. 10, 2016	Army	99	96	99	98	97	93	582	30	98	94	96	99	99	98	584	35
Eli Rischling	Memphis	Oct. 10, 2016	Army	91	91	100	99	91	90	562	21	96	96	93	98	94	97	574	23
Abby Votava	Memphis	Oct. 10, 2016	Army	0	0	0	0	0	0	0	0	0	0	0	0	0	0	0	0
Spencer Brandon	Air Force	Oct. 10, 2016	Alaska Fairbanks	96	92	98	99	97	96	578	27	99	98	99	100	98	99	593	43
Spencer Cap	Air Force	Oct. 10, 2016	Alaska Fairbanks	98	97	100	100	92	96	583	30	98	98	99	99	100	100	594	46
Kyle Cox	Air Force	Oct. 10, 2016	Alaska Fairbanks	0	0	0	0	0	0	0	0	0	0	0	0	0	0	0	0
Ryan Jacobs	Air Force	Oct. 10, 2016	Alaska Fairbanks	95	95	100	97	96	98	581	28	97	98	99	99	97	98	588	42
Noah Kwock	Air Force	Oct. 10, 2016	Alaska Fairbanks	0	0	0	0	0	0	0	0	0	0	0	0	0	0	0	0
Nick Learn	Air Force	Oct. 10, 2016	Alaska Fairbanks	94	95	100	97	92	96	574	24	98	98	98	98	98	100	590	37
Logan Ogden	Air Force	Oct. 10, 2016	Alaska Fairbanks	98	95	99	97	94	96	579	28	98	99	99	100	98	98	592	43
Mary Simonton	Air Force	Oct. 10, 2016	Alaska Fairbanks	0	0	0	0	0	0	0	0	0	0	0	0	0	0	0	0
Anna Weilbacher	Air Force	Oct. 10, 2016	Alaska Fairbanks	100	98	100	99	93	94	584	29	100	99	100	98	100	99	596	45
Nicholle Benedict	TCU	Oct. 10, 2016	Alaska Fairbanks	0	0	0	0	0	0	0	0	0	0	0	0	0	0	0	0
Katie Bridges	TCU	Oct. 10, 2016	Alaska Fairbanks	0	0	0	0	0	0	0	0	0	0	0	0	0	0	0	0
Rachel Garner	TCU	Oct. 10, 2016	Alaska Fairbanks	96	95	100	100	91	91	573	24	100	99	99	99	100	99	596	46
Ariana Grabowski	TCU	Oct. 10, 2016	Alaska Fairbanks	100	98	99	99	96	96	588	37	96	99	96	98	98	98	585	34
Emily Haag	TCU	Oct. 10, 2016	Alaska Fairbanks	95	94	95	96	88	92	560	16	94	95	99	99	98	98	583	36
Nicole Hankey	TCU	Oct. 10, 2016	Alaska Fairbanks	97	97	97	98	93	96	578	24	98	98	99	100	97	96	588	39
Rachel Kimbell	TCU	Oct. 10, 2016	Alaska Fairbanks	97	97	96	98	96	94	578	23	97	98	97	97	96	95	580	29
Sally Li	TCU	Oct. 10, 2016	Alaska Fairbanks	96	97	99	99	91	94	576	25	99	98	100	98	99	100	594	52
Casey Lutz	TCU	Oct. 10, 2016	Alaska Fairbanks	93	96	100	98	95	100	582	32	98	99	98	99	99	98	591	45
Mindy Miles	TCU	Oct. 10, 2016	Alaska Fairbanks	98	94	100	100	98	99	589	37	100	99	99	100	99	100	597	49
Catherine Miller	TCU	Oct. 10, 2016	Alaska Fairbanks	97	92	99	98	92	92	570	21	97	98	98	100	98	95	586	38
Meraleigh Randle	TCU	Oct. 10, 2016	Alaska Fairbanks	0	0	0	0	0	0	0	0	0	0	0	0	0	0	0	0
Barrett Ray	TCU	Oct. 10, 2016	Alaska Fairbanks	95	93	98	100	90	90	566	22	99	97	97	95	98	98	584	36
Soren Butler	Alaska Fairbanks	Oct. 14, 2016	Alaska Fairbanks	96	96	99	98	93	99	581	29	96	98	95	99	96	100	584	36
Liam Eberhart	Alaska Fairbanks	Oct. 14, 2016	Alaska Fairbanks	96	99	98	98	91	89	571	26	96	96	96	95	98	98	579	35
Amy Gentry	Alaska Fairbanks	Oct. 14, 2016	Alaska Fairbanks	95	94	98	95	92	97	571	22	97	97	98	99	98	97	586	33
Luke Johnson	Alaska Fairbanks	Oct. 14, 2016	Alaska Fairbanks	91	97	98	97	94	95	572	22	98	98	99	95	97	97	584	36
Sagen Maddalena	Alaska Fairbanks	Oct. 14, 2016	Alaska Fairbanks	100	98	99	100	95	95	587	40	99	100	100	99	100	98	596	54
Grace Nelson	Alaska Fairbanks	Oct. 14, 2016	Alaska Fairbanks	97	89	99	96	91	88	560	19	95	95	96	97	96	98	577	31
JT Schnering	Alaska Fairbanks	Oct. 14, 2016	Alaska Fairbanks	92	97	96	93	95	97	570	21	98	98	100	99	100	98	593	42
Robert Scott	Alaska Fairbanks	Oct. 14, 2016	Alaska Fairbanks	90	95	97	98	94	92	566	19	98	96	94	97	99	97	581	37
Nathan Taylor	Alaska Fairbanks	Oct. 14, 2016	Alaska Fairbanks	94	97	98	98	93	93	573	27	99	95	97	97	96	95	579	32
Deanna Binnie	Ohio State	Oct. 14, 2016	Alaska Fairbanks	0	0	0	0	0	0	0	0	0	0	0	0	0	0	0	0
Josh Black	Ohio State	Oct. 14, 2016	Alaska Fairbanks	98	100	98	99	95	93	583	31	98	99	99	99	100	97	592	46
Jacob Buchanan	Ohio State	Oct. 14, 2016	Alaska Fairbanks	97	95	99	99	92	94	576	31	97	98	98	98	94	98	583	32
Drew Cheezum	Ohio State	Oct. 14, 2016	Alaska Fairbanks	94	96	99	98	96	96	579	27	97	100	98	98	99	99	591	42
Anthony Cuozzo	Ohio State	Oct. 14, 2016	Alaska Fairbanks	0	0	0	0	0	0	0	0	0	0	0	0	0	0	0	0
Kendal Elder	Ohio State	Oct. 14, 2016	Alaska Fairbanks	0	0	0	0	0	0	0	0	0	0	0	0	0	0	0	0
Alli Kissell	Ohio State	Oct. 14, 2016	Alaska Fairbanks	0	0	0	0	0	0	0	0	0	0	0	0	0	0	0	0
Mark Matheny	Ohio State	Oct. 14, 2016	Alaska Fairbanks	95	98	98	99	95	93	578	27	99	100	98	99	99	100	595	46
Patrick Sardo	Ohio State	Oct. 14, 2016	Alaska Fairbanks	0	0	0	0	0	0	0	0	0	0	0	0	0	0	0	0
Michael Steinel	Ohio State	Oct. 14, 2016	Alaska Fairbanks	96	94	98	98	91	95	572	22	95	95	99	98	100	98	585	41
Chrissy Thomas	Ohio State	Oct. 14, 2016	Alaska Fairbanks	0	0	0	0	0	0	0	0	0	0	0	0	0	0	0	0
Rhiann Travis	Ohio State	Oct. 14, 2016	Alaska Fairbanks	95	91	100	100	97	93	576	27	100	99	98	99	99	100	595	49
Bailey Urbach	Ohio State	Oct. 14, 2016	Alaska Fairbanks	0	0	0	0	0	0	0	0	0	0	0	0	0	0	0	0
Brendan Whitaker	Ohio State	Oct. 14, 2016	Alaska Fairbanks	0	0	0	0	0	0	0	0	0	0	0	0	0	0	0	0
Quintin Wotring	Ohio State	Oct. 14, 2016	Alaska Fairbanks	96	96	98	99	92	93	574	18	93	97	99	97	95	96	577	32
Soren Butler	Alaska Fairbanks	Oct. 15, 2016	Alaska Fairbanks	95	96	99	100	97	95	582	30	99	94	98	98	95	95	579	31
Liam Eberhart	Alaska Fairbanks	Oct. 15, 2016	Alaska Fairbanks	98	96	99	96	93	90	572	20	96	98	99	98	97	95	583	30
Amy Gentry	Alaska Fairbanks	Oct. 15, 2016	Alaska Fairbanks	94	92	94	98	92	93	563	14	96	100	97	99	94	100	586	41
Luke Johnson	Alaska Fairbanks	Oct. 15, 2016	Alaska Fairbanks	97	94	97	100	96	94	578	25	98	95	99	98	96	99	585	35
Sagen Maddalena	Alaska Fairbanks	Oct. 15, 2016	Alaska Fairbanks	98	98	99	99	96	98	588	35	99	99	100	100	100	100	598	49
Grace Nelson	Alaska Fairbanks	Oct. 15, 2016	Alaska Fairbanks	91	97	100	97	93	93	571	20	97	99	96	94	95	95	576	25
JT Schnering	Alaska Fairbanks	Oct. 15, 2016	Alaska Fairbanks	99	97	100	99	96	93	584	32	100	97	100	97	100	97	591	42
Robert Scott	Alaska Fairbanks	Oct. 15, 2016	Alaska Fairbanks	91	96	94	97	93	92	563	18	95	99	95	98	96	98	581	36
Nathan Taylor	Alaska Fairbanks	Oct. 15, 2016	Alaska Fairbanks	94	95	92	97	97	97	572	25	94	95	92	97	97	97	572	27
Deanna Binnie	Ohio State	Oct. 15, 2016	Alaska Fairbanks	0	0	0	0	0	0	0	0	0	0	0	0	0	0	0	0
Josh Black	Ohio State	Oct. 15, 2016	Alaska Fairbanks	96	97	99	100	95	95	582	27	98	98	97	97	99	97	586	40
Jacob Buchanan	Ohio State	Oct. 15, 2016	Alaska Fairbanks	98	98	97	82	93	94	562	20	96	98	99	98	100	98	589	39
Drew Cheezum	Ohio State	Oct. 15, 2016	Alaska Fairbanks	97	97	96	97	96	96	579	20	96	100	100	99	97	99	591	44
Anthony Cuozzo	Ohio State	Oct. 15, 2016	Alaska Fairbanks	0	0	0	0	0	0	0	0	0	0	0	0	0	0	0	0
Kendal Elder	Ohio State	Oct. 15, 2016	Alaska Fairbanks	0	0	0	0	0	0	0	0	0	0	0	0	0	0	0	0
Alli Kissell	Ohio State	Oct. 15, 2016	Alaska Fairbanks	0	0	0	0	0	0	0	0	0	0	0	0	0	0	0	0
Mark Matheny	Ohio State	Oct. 15, 2016	Alaska Fairbanks	95	97	99	97	97	95	580	29	98	97	98	97	100	98	588	39
Patrick Sardo	Ohio State	Oct. 15, 2016	Alaska Fairbanks	0	0	0	0	0	0	0	0	0	0	0	0	0	0	0	0
Michael Steinel	Ohio State	Oct. 15, 2016	Alaska Fairbanks	94	95	98	99	93	94	573	24	98	96	97	98	99	100	588	35
Chrissy Thomas	Ohio State	Oct. 15, 2016	Alaska Fairbanks	0	0	0	0	0	0	0	0	0	0	0	0	0	0	0	0
Rhiann Travis	Ohio State	Oct. 15, 2016	Alaska Fairbanks	96	97	99	98	93	98	581	32	98	100	99	99	99	99	594	43
Bailey Urbach	Ohio State	Oct. 15, 2016	Alaska Fairbanks	0	0	0	0	0	0	0	0	0	0	0	0	0	0	0	0
Brendan Whitaker	Ohio State	Oct. 15, 2016	Alaska Fairbanks	0	0	0	0	0	0	0	0	0	0	0	0	0	0	0	0
Quintin Wotring	Ohio State	Oct. 15, 2016	Alaska Fairbanks	96	90	99	99	96	94	574	25	98	94	98	96	97	95	578	34
Seth Baker	Morehead St.	Oct. 15, 2016	Morehead St.	96	96	98	100	95	91	576	0	96	96	97	97	96	97	579	0
Brandon Bryer	Morehead St.	Oct. 15, 2016	Morehead St.	95	92	97	94	94	93	565	0	95	97	97	97	97	95	578	0
Siarra Crum	Morehead St.	Oct. 15, 2016	Morehead St.	91	89	91	95	92	88	546	0	95	96	96	96	97	95	575	0
Sarah Fink	Morehead St.	Oct. 15, 2016	Morehead St.	95	93	97	95	93	92	565	0	96	98	99	97	97	99	586	0
Joe Fischer	Morehead St.	Oct. 15, 2016	Morehead St.	95	99	98	99	93	88	572	0	98	94	99	97	97	96	581	0
Dan Hall	Morehead St.	Oct. 15, 2016	Morehead St.	97	95	97	98	94	91	572	0	97	93	93	95	94	95	567	0
Jesse Moyer	Morehead St.	Oct. 15, 2016	Morehead St.	98	91	97	97	96	93	572	0	96	97	97	98	97	97	582	0
Alexa Potts	Morehead St.	Oct. 15, 2016	Morehead St.	95	94	96	96	88	87	556	0	94	97	98	95	97	92	573	0
Karly Potts	Morehead St.	Oct. 15, 2016	Morehead St.	96	94	98	98	92	88	566	0	97	100	99	97	94	97	584	0
Melanie West	Morehead St.	Oct. 15, 2016	Morehead St.	92	95	96	99	89	84	555	0	92	91	91	93	96	97	560	0
Haley Wilson	Morehead St.	Oct. 15, 2016	Morehead St.	96	92	98	96	92	92	566	0	98	96	97	97	99	98	585	0
William Davidson	VMI	Oct. 15, 2016	Morehead St.	0	0	0	0	0	0	0	0	97	96	95	96	99	97	580	0
Andrew Hickey	VMI	Oct. 15, 2016	Morehead St.	96	93	99	99	93	85	565	0	94	99	94	92	99	91	569	0
Jacob Hunter	VMI	Oct. 15, 2016	Morehead St.	0	0	0	0	0	0	0	0	95	94	97	97	93	96	572	0
Zachary Johnson	VMI	Oct. 15, 2016	Morehead St.	92	84	98	98	91	84	547	0	89	91	95	96	93	91	555	0
Mathew Lusardi	VMI	Oct. 15, 2016	Morehead St.	95	94	96	100	87	80	552	0	0	0	0	0	0	0	0	0
Chris Milliken	VMI	Oct. 15, 2016	Morehead St.	0	0	0	0	0	0	0	0	0	0	0	0	0	0	0	0
John Pitman	VMI	Oct. 15, 2016	Morehead St.	93	87	98	97	84	89	548	0	0	0	0	0	0	0	0	0
Nick Reynolds	VMI	Oct. 15, 2016	Morehead St.	88	93	97	95	82	85	540	0	93	95	94	94	94	98	568	0
Kelia Aardema	VMI (W)	Oct. 15, 2016	Morehead St.	0	0	0	0	0	0	0	0	0	0	0	0	0	0	0	0
Samantha Alexander	VMI (W)	Oct. 15, 2016	Morehead St.	85	93	96	92	88	88	542	0	94	91	96	93	94	94	562	0
Ellana Avery	VMI (W)	Oct. 15, 2016	Morehead St.	85	93	98	93	63	61	493	0	0	0	0	0	0	0	0	0
Sabrina Bell	VMI (W)	Oct. 15, 2016	Morehead St.	0	0	0	0	0	0	0	0	0	0	0	0	0	0	0	0
Alice Chiu	VMI (W)	Oct. 15, 2016	Morehead St.	92	91	97	97	88	87	552	0	94	92	97	96	99	92	570	0
Jamie Foster	VMI (W)	Oct. 15, 2016	Morehead St.	0	0	0	0	0	0	0	0	0	0	0	0	0	0	0	0
Joelle Henry	VMI (W)	Oct. 15, 2016	Morehead St.	0	0	0	0	0	0	0	0	0	0	0	0	0	0	0	0
Rachel Jankelow	VMI (W)	Oct. 15, 2016	Morehead St.	0	0	0	0	0	0	0	0	91	95	95	96	90	93	560	0
Kerrie Lightfoot	VMI (W)	Oct. 15, 2016	Morehead St.	0	0	0	0	0	0	0	0	89	91	87	97	91	93	548	0
Loyce Lightfoot	VMI (W)	Oct. 15, 2016	Morehead St.	84	89	96	97	85	87	538	0	0	0	0	0	0	0	0	0
Kaitlyn Morrison	VMI (W)	Oct. 15, 2016	Morehead St.	0	0	0	0	0	0	0	0	0	0	0	0	0	0	0	0
Katherine Watson	VMI (W)	Oct. 15, 2016	Morehead St.	89	87	95	94	91	89	545	0	89	91	98	92	92	95	557	0
Lauryn Cinadr	Akron	Oct. 15, 2016	Nevada Reno	0	0	0	0	0	0	0	0	0	0	0	0	0	0	0	0
Alex Fedorko	Akron	Oct. 15, 2016	Nevada Reno	0	0	0	0	0	0	0	0	0	0	0	0	0	0	0	0
Sydney Goldschlag	Akron	Oct. 15, 2016	Nevada Reno	0	0	0	0	0	0	0	0	0	0	0	0	0	0	0	0
Rebecca Green	Akron	Oct. 15, 2016	Nevada Reno	0	0	0	0	0	0	0	0	0	0	0	0	0	0	0	0
Julia Hatch	Akron	Oct. 15, 2016	Nevada Reno	97	99	98	99	96	93	582	0	98	97	98	92	95	95	575	0
Anthony Jackson	Akron	Oct. 15, 2016	Nevada Reno	92	95	98	99	96	92	572	0	96	96	96	96	93	96	573	0
Kera Kaufman	Akron	Oct. 15, 2016	Nevada Reno	0	0	0	0	0	0	0	0	0	0	0	0	0	0	0	0
Joshua Kovach	Akron	Oct. 15, 2016	Nevada Reno	0	0	0	0	0	0	0	0	0	0	0	0	0	0	0	0
Caleb Lloyd	Akron	Oct. 15, 2016	Nevada Reno	96	95	98	99	88	94	570	0	94	97	93	96	97	97	574	0
Danielle Makucevich	Akron	Oct. 15, 2016	Nevada Reno	0	0	0	0	0	0	0	0	0	0	0	0	0	0	0	0
Kris Mantel	Akron	Oct. 15, 2016	Nevada Reno	0	0	0	0	0	0	0	0	0	0	0	0	0	0	0	0
Brent Morgan	Akron	Oct. 15, 2016	Nevada Reno	0	0	0	0	0	0	0	0	0	0	0	0	0	0	0	0
Connor O'Mara	Akron	Oct. 15, 2016	Nevada Reno	92	96	97	98	91	99	573	0	96	99	96	100	96	98	585	0
Marlee Reynolds	Akron	Oct. 15, 2016	Nevada Reno	0	0	0	0	0	0	0	0	0	0	0	0	0	0	0	0
Sean Roehrs	Akron	Oct. 15, 2016	Nevada Reno	0	0	0	0	0	0	0	0	0	0	0	0	0	0	0	0
Zach Strohl	Akron	Oct. 15, 2016	Nevada Reno	96	94	98	99	93	93	573	0	95	99	96	100	98	99	587	0
Cierra Terrizzi	Akron	Oct. 15, 2016	Nevada Reno	92	95	98	97	97	96	575	0	99	95	97	93	82	98	564	0
Rachel Benesh	Nevada	Oct. 15, 2016	Nevada Reno	95	96	100	97	89	96	573	0	97	96	97	96	98	95	579	0
Emily Capaul	Nevada	Oct. 15, 2016	Nevada Reno	93	91	96	99	95	94	568	0	98	98	95	98	98	97	584	0
Jared Crews	Nevada	Oct. 15, 2016	Nevada Reno	0	0	0	0	0	0	0	0	0	0	0	0	0	0	0	0
Maneva Gill	Nevada	Oct. 15, 2016	Nevada Reno	0	0	0	0	0	0	0	0	0	0	0	0	0	0	0	0
Sarah Jameson	Nevada	Oct. 15, 2016	Nevada Reno	98	98	97	99	96	96	584	0	97	99	95	99	97	99	586	0
Eli Larimer	Nevada	Oct. 15, 2016	Nevada Reno	92	94	99	100	89	92	566	0	96	97	94	97	95	99	578	0
Justin Nissen	Nevada	Oct. 15, 2016	Nevada Reno	94	92	96	97	90	90	559	0	98	98	96	98	99	100	589	0
Jami Sexton	Nevada	Oct. 15, 2016	Nevada Reno	0	0	0	0	0	0	0	0	0	0	0	0	0	0	0	0
Sara Tashima	Nevada	Oct. 15, 2016	Nevada Reno	0	0	0	0	0	0	0	0	0	0	0	0	0	0	0	0
Mitchell Van Patten	Nevada	Oct. 15, 2016	Nevada Reno	97	98	97	100	94	96	582	0	99	100	99	98	99	99	594	0
Billy Azzinaro	Kentucky	Oct. 15, 2016	Navy	97	98	99	99	98	97	588	0	98	99	97	96	99	100	589	0
Jenna Bethea	Kentucky	Oct. 15, 2016	Navy	0	0	0	0	0	0	0	0	0	0	0	0	0	0	0	0
Hanna Carr	Kentucky	Oct. 15, 2016	Navy	95	97	99	99	95	99	584	0	96	95	99	100	98	97	585	0
Morgan Duerr	Kentucky	Oct. 15, 2016	Navy	0	0	0	0	0	0	0	0	0	0	0	0	0	0	0	0
Ian Foos	Kentucky	Oct. 15, 2016	Navy	0	0	0	0	0	0	0	0	0	0	0	0	0	0	0	0
Carmen Fry	Kentucky	Oct. 15, 2016	Navy	0	0	0	0	0	0	0	0	0	0	0	0	0	0	0	0
Heather Kirby	Kentucky	Oct. 15, 2016	Navy	94	97	99	98	93	94	575	0	100	99	99	99	97	99	593	0
Sonya May	Kentucky	Oct. 15, 2016	Navy	90	99	98	97	95	98	577	0	99	100	99	97	99	99	593	0
Andrew Miller	Kentucky	Oct. 15, 2016	Navy	0	0	0	0	0	0	0	0	0	0	0	0	0	0	0	0
Cathryn Papasodora	Kentucky	Oct. 15, 2016	Navy	92	96	100	98	97	93	576	0	99	97	97	98	96	98	585	0
Jason Scharbel	Kentucky	Oct. 15, 2016	Navy	97	96	100	98	95	91	577	0	97	98	99	97	99	100	590	0
Jason Spaude	Kentucky	Oct. 15, 2016	Navy	97	99	96	98	94	95	579	0	98	97	97	100	98	98	588	0
Lucas Figi	Navy	Oct. 15, 2016	Navy	0	0	0	0	0	0	0	0	0	0	0	0	0	0	0	0
Maggie Guetersloh	Navy	Oct. 15, 2016	Navy	89	94	98	95	88	88	552	0	98	97	96	95	94	97	577	0
Amy Hammer	Navy	Oct. 15, 2016	Navy	96	96	96	97	93	95	573	0	98	100	98	97	98	97	588	0
Daniel Jonas	Navy	Oct. 15, 2016	Navy	97	98	98	99	94	94	580	0	95	99	98	97	97	96	582	0
Kestrel Kuhne	Navy	Oct. 15, 2016	Navy	93	93	98	99	93	91	567	0	92	97	97	97	99	93	575	0
Alex Muzzioli	Navy	Oct. 15, 2016	Navy	93	98	98	99	95	91	574	0	97	98	97	97	98	96	583	0
Brandon Pippin	Navy	Oct. 15, 2016	Navy	0	0	0	0	0	0	0	0	97	91	95	94	97	96	570	0
Nash Richardson	Navy	Oct. 15, 2016	Navy	94	94	98	98	94	93	571	0	97	94	96	94	91	95	567	0
Thomas Sarant	Navy	Oct. 15, 2016	Navy	98	97	99	99	94	93	580	0	99	95	99	98	99	94	584	0
Josh Watson	Navy	Oct. 15, 2016	Navy	98	97	96	99	94	91	575	0	99	98	96	98	94	97	582	0
Allison Auten	Citadel	Oct. 15, 2016	Citadel	90	91	99	94	92	96	562	0	93	95	94	98	97	97	574	0
Matthew Davenport	Citadel	Oct. 15, 2016	Citadel	85	82	91	91	85	88	522	0	89	97	95	98	98	93	570	0
Joseph Ferguson	Citadel	Oct. 15, 2016	Citadel	86	86	93	92	84	86	527	0	97	93	93	93	90	94	560	0
Morgan Long	Citadel	Oct. 15, 2016	Citadel	89	80	94	97	93	92	545	0	99	93	94	93	99	94	572	0
Alexander McAlear	Citadel	Oct. 15, 2016	Citadel	95	91	94	97	87	86	550	0	91	93	93	93	94	93	557	0
Patrick Meyer	Citadel	Oct. 15, 2016	Citadel	0	0	0	0	0	0	0	0	0	0	0	0	0	0	0	0
Richie Parra	Citadel	Oct. 15, 2016	Citadel	86	82	97	95	82	88	530	0	91	94	97	96	94	96	568	0
Colton Poole	Citadel	Oct. 15, 2016	Citadel	89	90	94	97	92	88	550	0	93	94	91	90	95	95	558	0
Tommy Simrill	Citadel	Oct. 15, 2016	Citadel	84	83	83	93	79	72	494	0	93	84	95	89	91	91	543	0
Sarah Banks	Alabama Birmingham	Oct. 15, 2016	Citadel	0	0	0	0	0	0	0	0	95	93	92	95	91	96	562	0
Steven Bugg	Alabama Birmingham	Oct. 15, 2016	Citadel	0	0	0	0	0	0	0	0	88	91	93	94	89	84	539	0
Selina Curren	Alabama Birmingham	Oct. 15, 2016	Citadel	96	86	93	97	93	90	555	0	98	93	93	91	95	93	563	0
Lindsey Hill	Alabama Birmingham	Oct. 15, 2016	Citadel	0	0	0	0	0	0	0	0	0	0	0	0	0	0	0	0
Isaac King	Alabama Birmingham	Oct. 15, 2016	Citadel	0	0	0	0	0	0	0	0	93	90	93	95	89	84	544	0
Kristie Lloyd	Alabama Birmingham	Oct. 15, 2016	Citadel	0	0	0	0	0	0	0	0	95	92	94	91	91	94	557	0
Logan Short	Alabama Birmingham	Oct. 15, 2016	Citadel	0	0	0	0	0	0	0	0	0	0	0	0	0	0	0	0
Mallory Sisk	Alabama Birmingham	Oct. 15, 2016	Citadel	0	0	0	0	0	0	0	0	0	0	0	0	0	0	0	0
Micah Smith	Alabama Birmingham	Oct. 15, 2016	Citadel	0	0	0	0	0	0	0	0	0	0	0	0	0	0	0	0
Emily Stover	Alabama Birmingham	Oct. 15, 2016	Citadel	0	0	0	0	0	0	0	0	94	92	88	92	92	91	549	0
Ella Von Canon	Alabama Birmingham	Oct. 15, 2016	Citadel	0	0	0	0	0	0	0	0	95	91	94	93	89	92	554	0
Lilly Vonderau	Alabama Birmingham	Oct. 15, 2016	Citadel	0	0	0	0	0	0	0	0	97	94	96	97	100	95	579	0
Rosemary Kramer	Ga. Southern	Oct. 15, 2016	Citadel	91	94	99	95	91	92	562	0	97	96	98	96	96	95	578	0
Tori Lewis	Ga. Southern	Oct. 15, 2016	Citadel	91	92	96	96	92	92	559	0	96	94	98	97	96	95	576	0
Jennifer Middlebrook	Ga. Southern	Oct. 15, 2016	Citadel	89	87	88	91	88	79	522	0	90	91	90	86	86	89	532	0
Lydia Odlin	Ga. Southern	Oct. 15, 2016	Citadel	90	92	98	97	75	78	530	0	92	94	94	93	94	95	562	0
Chastity Price	Ga. Southern	Oct. 15, 2016	Citadel	0	0	0	0	0	0	0	0	0	0	0	0	0	0	0	0
Courtney Weekley	Ga. Southern	Oct. 15, 2016	Citadel	92	91	95	94	87	92	551	0	92	99	97	94	94	97	573	0
Kathryn Youngblood	Ga. Southern	Oct. 15, 2016	Citadel	0	0	0	0	0	0	0	0	0	0	0	0	0	0	0	0
Carli Cline	Citadel (W)	Oct. 15, 2016	Citadel	0	0	0	0	0	0	0	0	0	0	0	0	0	0	0	0
Brandi Duzz	Citadel (W)	Oct. 15, 2016	Citadel	91	90	94	93	83	82	533	0	93	93	87	96	90	88	547	0
Leah Fenwrick-Wallace	Citadel (W)	Oct. 15, 2016	Citadel	89	81	91	84	78	81	504	0	91	92	91	94	93	90	551	0
Shadonna Littlejohn	Citadel (W)	Oct. 15, 2016	Citadel	0	0	0	0	0	0	0	0	88	91	95	91	86	91	542	0
Tierra Price	Citadel (W)	Oct. 15, 2016	Citadel	51	72	91	88	41	49	392	0	74	83	77	91	89	81	495	0
Faith Totherow	Citadel (W)	Oct. 15, 2016	Citadel	82	78	96	94	83	81	514	0	83	86	85	79	80	92	505	0
Raven Wills	Citadel (W)	Oct. 15, 2016	Citadel	85	86	96	89	77	71	504	0	86	93	88	84	87	89	527	0
Katie Brown	Nebraska	Oct. 15, 2016	Ole Miss	93	93	95	97	93	92	563	17	96	96	89	91	97	92	561	24
Jaycee Carter	Nebraska	Oct. 15, 2016	Ole Miss	96	94	96	98	98	92	574	25	97	96	98	98	98	96	583	33
Dacotah Faught	Nebraska	Oct. 15, 2016	Ole Miss	95	96	100	99	92	94	576	25	99	98	99	98	98	100	592	44
Kayla Gadeken	Nebraska	Oct. 15, 2016	Ole Miss	96	94	100	100	95	93	578	24	96	98	99	98	97	97	585	40
Maddie Korthas	Nebraska	Oct. 15, 2016	Ole Miss	94	89	96	96	90	91	556	11	93	96	97	93	98	96	573	30
Rachel Martin	Nebraska	Oct. 15, 2016	Ole Miss	96	96	100	100	89	92	573	30	100	99	97	100	98	95	589	45
Jordan Miller	Nebraska	Oct. 15, 2016	Ole Miss	0	0	0	0	0	0	0	0	0	0	0	0	0	0	0	0
Samantha Peterson	Nebraska	Oct. 15, 2016	Ole Miss	100	98	100	100	94	92	584	32	97	96	99	97	99	99	587	37
Nina Radulovic	Nebraska	Oct. 15, 2016	Ole Miss	92	94	98	98	89	88	559	16	98	98	97	96	98	97	584	32
Sarah Sutton	Nebraska	Oct. 15, 2016	Ole Miss	99	89	97	98	89	92	564	22	97	96	91	98	98	92	572	27
Hannah Virga	Nebraska	Oct. 15, 2016	Ole Miss	93	96	95	98	94	91	567	19	95	96	98	96	100	98	583	31
Rachel Yager	Nebraska	Oct. 15, 2016	Ole Miss	93	93	96	98	94	89	563	25	94	97	98	91	97	97	574	32
Hayley Carroll	Ole Miss	Oct. 15, 2016	Ole Miss	89	92	97	100	91	94	563	18	98	97	96	96	97	96	580	32
Harley Gardner	Ole Miss	Oct. 15, 2016	Ole Miss	97	95	98	98	94	95	577	27	100	97	98	96	96	96	583	36
Jess Haig	Ole Miss	Oct. 15, 2016	Ole Miss	93	98	97	97	92	92	569	21	99	98	96	99	100	99	591	0
Alana Kelly	Ole Miss	Oct. 15, 2016	Ole Miss	94	95	98	99	91	93	570	21	99	99	96	98	97	97	586	36
Randi Loudin	Ole Miss	Oct. 15, 2016	Ole Miss	95	92	98	98	93	89	565	27	99	97	99	95	96	97	583	35
Marina Noble	Ole Miss	Oct. 15, 2016	Ole Miss	91	92	96	99	93	86	557	19	0	0	0	0	0	0	0	0
Samantha Sandifer	Ole Miss	Oct. 15, 2016	Ole Miss	93	95	94	95	86	90	553	14	98	96	95	96	94	90	569	20
Kristyn Trump	Ole Miss	Oct. 15, 2016	Ole Miss	93	94	98	99	88	88	560	23	97	97	99	98	98	98	587	36
Jillian Tyler	Ole Miss	Oct. 15, 2016	Ole Miss	95	93	100	97	95	95	575	26	94	98	99	97	97	98	583	37
Ali Weisz	Ole Miss	Oct. 15, 2016	Ole Miss	98	97	99	100	93	94	581	24	100	100	99	100	100	98	597	54
Zach Eisenberg	North Carolina St.	Oct. 15, 2016	North Carolina St.	93	91	98	97	91	91	561	21	96	97	97	99	96	96	581	33
Caitlyn Ford	North Carolina St.	Oct. 15, 2016	North Carolina St.	93	95	97	96	92	94	567	19	100	99	98	98	97	97	589	41
Sarah Hickey	North Carolina St.	Oct. 15, 2016	North Carolina St.	0	0	0	0	0	0	0	0	0	0	0	0	0	0	0	0
Lucas Kozeniesky	North Carolina St.	Oct. 15, 2016	North Carolina St.	95	96	99	98	96	98	582	31	98	100	99	100	99	98	594	48
Tyler Lefebvre	North Carolina St.	Oct. 15, 2016	North Carolina St.	0	0	0	0	0	0	0	0	0	0	0	0	0	0	0	0
Will Marciniak	North Carolina St.	Oct. 15, 2016	North Carolina St.	98	92	98	98	94	95	575	22	0	0	0	0	0	0	0	0
Derya Pekari	North Carolina St.	Oct. 15, 2016	North Carolina St.	91	97	99	100	89	91	567	24	97	97	99	98	99	98	588	36
Lauren Phillips	North Carolina St.	Oct. 15, 2016	North Carolina St.	97	94	99	99	97	95	581	24	100	99	100	98	98	100	595	44
Claire Spina	North Carolina St.	Oct. 15, 2016	North Carolina St.	0	0	0	0	0	0	0	0	0	0	0	0	0	0	0	0
Cullen Wargo	North Carolina St.	Oct. 15, 2016	North Carolina St.	0	0	0	0	0	0	0	0	96	94	98	95	94	97	574	26
George Williams	North Carolina St.	Oct. 15, 2016	North Carolina St.	0	0	0	0	0	0	0	0	0	0	0	0	0	0	0	0
Claire Zanti	North Carolina St.	Oct. 15, 2016	North Carolina St.	0	0	0	0	0	0	0	0	0	0	0	0	0	0	0	0
Jack Anderson	West Virginia	Oct. 15, 2016	North Carolina St.	0	0	0	0	0	0	0	0	93	99	98	97	97	93	577	31
Will Anti	West Virginia	Oct. 15, 2016	North Carolina St.	91	96	99	99	94	96	575	25	98	99	98	97	98	98	588	41
Milica Babic	West Virginia	Oct. 15, 2016	North Carolina St.	94	95	99	98	93	99	578	29	98	99	100	100	100	99	596	52
Noah Barker	West Virginia	Oct. 15, 2016	North Carolina St.	0	0	0	0	0	0	0	0	0	0	0	0	0	0	0	0
Elizabeth Gratz	West Virginia	Oct. 15, 2016	North Carolina St.	97	99	99	100	97	96	588	34	95	99	99	99	100	100	592	37
Jean-Pierre Lucas	West Virginia	Oct. 15, 2016	North Carolina St.	97	98	100	99	96	94	584	30	98	99	99	99	99	97	591	43
Morgan Phillips	West Virginia	Oct. 15, 2016	North Carolina St.	97	98	99	99	97	97	587	32	0	0	0	0	0	0	0	0
Ginny Thrasher	West Virginia	Oct. 15, 2016	North Carolina St.	96	98	100	99	96	95	584	31	100	98	100	99	100	99	596	49
Seth Baker	Morehead St.	Oct. 16, 2016	Morehead St.	96	96	99	98	91	93	573	0	93	97	95	97	95	97	574	0
Brandon Bryer	Morehead St.	Oct. 16, 2016	Morehead St.	94	90	96	98	91	95	564	0	93	95	97	100	97	95	577	0
Siarra Crum	Morehead St.	Oct. 16, 2016	Morehead St.	0	0	0	0	0	0	0	0	98	97	99	97	97	97	585	0
Sarah Fink	Morehead St.	Oct. 16, 2016	Morehead St.	94	99	98	98	95	92	576	0	94	96	95	100	97	96	578	0
Joe Fischer	Morehead St.	Oct. 16, 2016	Morehead St.	94	96	98	100	91	93	572	0	92	92	95	97	95	96	567	0
Dan Hall	Morehead St.	Oct. 16, 2016	Morehead St.	97	95	98	99	93	84	566	0	94	95	97	94	93	98	571	0
Jesse Moyer	Morehead St.	Oct. 16, 2016	Morehead St.	93	96	95	96	90	92	562	0	95	98	97	97	97	97	581	0
Alexa Potts	Morehead St.	Oct. 16, 2016	Morehead St.	97	96	96	98	84	88	559	0	96	94	97	95	94	97	573	0
Karly Potts	Morehead St.	Oct. 16, 2016	Morehead St.	94	93	97	98	90	93	565	0	97	98	99	97	99	97	587	0
Melanie West	Morehead St.	Oct. 16, 2016	Morehead St.	0	0	0	0	0	0	0	0	97	93	96	92	93	95	566	0
Haley Wilson	Morehead St.	Oct. 16, 2016	Morehead St.	93	93	98	99	91	93	567	0	97	99	97	97	96	95	581	0
Hunter Behrends	Jacksonville St.	Oct. 16, 2016	Morehead St.	0	0	0	0	0	0	0	0	0	0	0	0	0	0	0	0
Austin Cock	Jacksonville St.	Oct. 16, 2016	Morehead St.	0	0	0	0	0	0	0	0	95	94	97	97	97	93	573	0
Anika Corsi	Jacksonville St.	Oct. 16, 2016	Morehead St.	0	0	0	0	0	0	0	0	96	95	97	96	98	97	579	0
Trace Haynes	Jacksonville St.	Oct. 16, 2016	Morehead St.	95	96	97	100	91	94	573	0	97	96	97	98	98	97	583	0
Brandon Henson	Jacksonville St.	Oct. 16, 2016	Morehead St.	0	0	0	0	0	0	0	0	0	0	0	0	0	0	0	0
Brandon Muske	Jacksonville St.	Oct. 16, 2016	Morehead St.	95	97	97	98	94	92	573	0	100	100	98	98	99	100	595	0
Kyle Ordille	Jacksonville St.	Oct. 16, 2016	Morehead St.	0	0	0	0	0	0	0	0	0	0	0	0	0	0	0	0
Carleigh Peters	Jacksonville St.	Oct. 16, 2016	Morehead St.	0	0	0	0	0	0	0	0	100	98	99	96	95	98	586	0
Garrett Rabel	Jacksonville St.	Oct. 16, 2016	Morehead St.	96	95	97	98	93	92	571	0	0	0	0	0	0	0	0	0
Tyler Ramos	Jacksonville St.	Oct. 16, 2016	Morehead St.	99	93	98	98	90	87	565	0	0	0	0	0	0	0	0	0
Mekenna Richardson	Jacksonville St.	Oct. 16, 2016	Morehead St.	98	96	100	98	86	97	575	0	95	99	95	95	96	97	577	0
Carter Santrock	Jacksonville St.	Oct. 16, 2016	Morehead St.	94	94	97	97	95	94	571	0	95	98	98	98	100	98	587	0
Zach Schmidt	Jacksonville St.	Oct. 16, 2016	Morehead St.	94	96	97	99	95	93	574	0	96	95	94	98	95	97	575	0
David Sink	Jacksonville St.	Oct. 16, 2016	Morehead St.	96	97	97	95	95	94	574	0	96	94	94	95	95	98	572	0
Melissa Brizzi	Coast Guard	Oct. 22, 2016	MIT	87	89	94	92	75	75	512	0	88	90	87	90	92	95	542	0
Joseph Busching	Coast Guard	Oct. 22, 2016	MIT	0	0	0	0	0	0	0	0	77	88	88	77	82	84	496	0
Jacob Dupree	Coast Guard	Oct. 22, 2016	MIT	87	90	93	92	84	72	518	0	90	88	93	91	89	88	539	0
Randall Ford	Coast Guard	Oct. 22, 2016	MIT	89	85	88	94	83	87	526	0	90	92	92	93	94	94	555	0
Marshall Grant	Coast Guard	Oct. 22, 2016	MIT	83	85	94	93	78	90	523	0	86	93	92	85	92	90	538	0
Alexandria Harrington	Coast Guard	Oct. 22, 2016	MIT	95	94	96	97	89	91	562	0	96	93	91	98	88	94	560	0
Anthony Lee	Coast Guard	Oct. 22, 2016	MIT	0	0	0	0	0	0	0	0	0	0	0	0	0	0	0	0
Dylan Lorence	Coast Guard	Oct. 22, 2016	MIT	95	89	94	94	90	89	551	0	88	94	88	82	93	82	527	0
Kaden Nichols	Coast Guard	Oct. 22, 2016	MIT	0	0	0	0	0	0	0	0	84	83	83	76	83	83	492	0
Nicholas Paisker	Coast Guard	Oct. 22, 2016	MIT	97	94	92	97	93	87	560	0	96	91	92	94	92	92	557	0
Paul Raynolds	Coast Guard	Oct. 22, 2016	MIT	0	0	0	0	0	0	0	0	0	0	0	0	0	0	0	0
David Rose	Coast Guard	Oct. 22, 2016	MIT	75	87	88	94	72	57	473	0	0	0	0	0	0	0	0	0
Alaric Stone	Coast Guard	Oct. 22, 2016	MIT	0	0	0	0	0	0	0	0	91	87	79	85	90	90	522	0
Nyjah Turner	Coast Guard	Oct. 22, 2016	MIT	93	81	90	93	81	78	516	0	80	88	90	90	90	90	528	0
William Caruso	MIT	Oct. 22, 2016	MIT	81	78	85	88	82	93	507	0	91	89	93	86	91	82	532	0
Efraim Helman	MIT	Oct. 22, 2016	MIT	0	0	0	0	0	0	0	0	0	0	0	0	0	0	0	0
Yaakov Helman	MIT	Oct. 22, 2016	MIT	0	0	0	0	0	0	0	0	0	0	0	0	0	0	0	0
Jesus Herrera	MIT	Oct. 22, 2016	MIT	79	75	84	83	74	71	466	0	83	78	86	86	68	80	481	0
Alexander Laiman	MIT	Oct. 22, 2016	MIT	86	86	94	95	77	80	518	0	89	89	85	79	85	88	515	0
Gregory Lee	MIT	Oct. 22, 2016	MIT	83	87	83	92	81	85	511	0	88	93	89	88	83	85	526	0
Kelly Mathesius	MIT	Oct. 22, 2016	MIT	88	87	93	94	79	91	532	0	94	85	93	86	92	82	532	0
Elijah Miller	MIT	Oct. 22, 2016	MIT	0	0	0	0	0	0	0	0	81	83	84	78	80	69	475	0
Dylan Modesitt	MIT	Oct. 22, 2016	MIT	88	85	89	88	82	77	509	0	82	76	89	90	84	89	510	0
Kevin Ng	MIT	Oct. 22, 2016	MIT	91	90	95	96	81	82	535	0	76	95	89	88	92	84	524	0
Alex Pacheco	MIT	Oct. 22, 2016	MIT	65	79	90	83	75	65	457	0	73	74	82	77	78	83	467	0
Kevin Petrovic	MIT	Oct. 22, 2016	MIT	72	78	89	90	67	51	447	0	61	78	79	61	73	69	421	0
Thomas Rick	MIT	Oct. 22, 2016	MIT	83	74	94	89	74	70	484	0	79	88	79	84	82	77	489	0
Joel Solis	MIT	Oct. 22, 2016	MIT	0	0	0	0	0	0	0	0	83	87	78	84	93	84	509	0
Lauryn Cinadr	Akron	Oct. 22, 2016	Akron	85	89	95	97	86	92	544	13	90	94	95	94	97	95	565	0
Alex Fedorko	Akron	Oct. 22, 2016	Akron	94	93	94	97	90	92	560	18	91	93	91	93	96	95	559	0
Sydney Goldschlag	Akron	Oct. 22, 2016	Akron	94	94	97	97	87	89	558	20	93	98	94	94	91	94	564	0
Rebecca Green	Akron	Oct. 22, 2016	Akron	90	93	96	95	89	90	553	19	97	98	95	95	92	95	572	0
Julia Hatch	Akron	Oct. 22, 2016	Akron	99	97	98	98	96	94	582	31	95	95	97	98	97	95	577	0
Anthony Jackson	Akron	Oct. 22, 2016	Akron	95	93	98	96	94	96	572	26	96	96	94	96	97	93	572	0
Kera Kaufman	Akron	Oct. 22, 2016	Akron	88	93	99	100	94	89	563	20	96	95	96	94	95	98	574	0
Joshua Kovach	Akron	Oct. 22, 2016	Akron	0	0	0	0	0	0	0	0	95	92	97	97	94	93	568	0
Caleb Lloyd	Akron	Oct. 22, 2016	Akron	95	94	99	100	96	94	578	26	96	98	99	95	94	96	578	0
Danielle Makucevich	Akron	Oct. 22, 2016	Akron	0	0	0	0	0	0	0	0	93	94	95	96	95	96	569	0
Kris Mantel	Akron	Oct. 22, 2016	Akron	88	86	97	96	83	79	529	0	93	95	90	92	88	95	553	0
Brent Morgan	Akron	Oct. 22, 2016	Akron	0	0	0	0	0	0	0	0	94	91	93	96	96	91	561	0
Connor O'Mara	Akron	Oct. 22, 2016	Akron	89	94	98	98	90	93	562	23	100	96	98	96	95	97	582	0
Marlee Reynolds	Akron	Oct. 22, 2016	Akron	91	86	93	99	88	85	542	16	95	94	97	89	92	93	560	0
Sean Roehrs	Akron	Oct. 22, 2016	Akron	91	94	98	95	91	87	556	15	95	98	97	95	96	96	577	0
Zach Strohl	Akron	Oct. 22, 2016	Akron	96	97	99	100	91	92	575	30	98	98	98	98	99	98	589	0
Cierra Terrizzi	Akron	Oct. 22, 2016	Akron	93	96	98	98	91	90	566	23	92	95	95	96	97	95	570	0
Zach Eisenberg	North Carolina St.	Oct. 22, 2016	Akron	89	91	97	97	90	94	558	21	96	95	96	98	99	97	581	0
Caitlyn Ford	North Carolina St.	Oct. 22, 2016	Akron	98	97	97	98	92	93	575	32	97	97	98	96	96	97	581	0
Sarah Hickey	North Carolina St.	Oct. 22, 2016	Akron	0	0	0	0	0	0	0	0	0	0	0	0	0	0	0	0
Lucas Kozeniesky	North Carolina St.	Oct. 22, 2016	Akron	96	96	95	99	93	93	572	23	99	99	99	100	100	100	597	0
Tyler Lefebvre	North Carolina St.	Oct. 22, 2016	Akron	93	96	98	98	93	92	570	24	95	96	94	94	91	96	566	0
Will Marciniak	North Carolina St.	Oct. 22, 2016	Akron	91	95	99	98	95	91	569	25	94	98	95	97	96	95	575	0
Derya Pekari	North Carolina St.	Oct. 22, 2016	Akron	95	87	97	94	84	91	548	15	95	98	97	96	98	96	580	0
Lauren Phillips	North Carolina St.	Oct. 22, 2016	Akron	93	95	100	99	98	96	581	33	98	98	100	99	100	100	595	0
Claire Spina	North Carolina St.	Oct. 22, 2016	Akron	0	0	0	0	0	0	0	0	0	0	0	0	0	0	0	0
Cullen Wargo	North Carolina St.	Oct. 22, 2016	Akron	0	0	0	0	0	0	0	0	0	0	0	0	0	0	0	0
George Williams	North Carolina St.	Oct. 22, 2016	Akron	0	0	0	0	0	0	0	0	0	0	0	0	0	0	0	0
Claire Zanti	North Carolina St.	Oct. 22, 2016	Akron	93	94	99	100	94	93	573	24	96	98	96	97	98	98	583	0
Jack Anderson	West Virginia	Oct. 22, 2016	Akron	94	94	94	97	92	93	564	16	98	97	98	94	98	98	583	0
Will Anti	West Virginia	Oct. 22, 2016	Akron	94	92	100	100	99	94	579	31	98	99	99	98	99	98	591	0
Milica Babic	West Virginia	Oct. 22, 2016	Akron	95	96	99	100	94	96	580	33	97	99	100	98	99	98	591	0
Noah Barker	West Virginia	Oct. 22, 2016	Akron	0	0	0	0	0	0	0	0	0	0	0	0	0	0	0	0
Elizabeth Gratz	West Virginia	Oct. 22, 2016	Akron	97	98	97	98	98	97	585	35	99	99	100	100	99	100	597	0
Jean-Pierre Lucas	West Virginia	Oct. 22, 2016	Akron	99	95	100	97	98	99	588	39	95	98	97	100	97	98	585	0
Morgan Phillips	West Virginia	Oct. 22, 2016	Akron	96	98	97	99	95	95	580	30	96	98	98	98	97	96	583	0
Ginny Thrasher	West Virginia	Oct. 22, 2016	Akron	98	98	100	100	98	99	593	48	100	100	100	100	100	99	599	0
Bobby Broadstreet	Murray St.	Oct. 22, 2016	Murray St.	97	99	99	99	94	93	581	0	100	100	98	96	98	99	591	0
Meike Drewell	Murray St.	Oct. 22, 2016	Murray St.	97	96	99	100	93	95	580	0	100	99	99	96	99	100	593	0
Ben Estes	Murray St.	Oct. 22, 2016	Murray St.	96	97	100	96	95	99	583	0	98	99	99	97	99	98	590	0
Shelby Huber	Murray St.	Oct. 22, 2016	Murray St.	96	93	98	99	95	93	574	0	96	96	98	96	94	98	578	0
Mackenzie Martin	Murray St.	Oct. 22, 2016	Murray St.	98	95	100	99	95	96	583	0	100	97	100	97	98	100	592	0
Ivan Roe	Murray St.	Oct. 22, 2016	Murray St.	98	97	98	99	95	96	583	0	99	98	99	100	99	100	595	0
Barbara Schlapfer	Murray St.	Oct. 22, 2016	Murray St.	94	97	99	99	96	93	578	0	99	95	99	99	99	99	590	0
Alathea Sellars	Murray St.	Oct. 22, 2016	Murray St.	93	95	98	100	95	94	575	0	99	97	99	100	98	98	591	0
Eric Sloan	Murray St.	Oct. 22, 2016	Murray St.	97	96	96	99	91	92	571	0	91	95	89	91	94	92	552	0
Nicholle Benedict	TCU	Oct. 22, 2016	Murray St.	0	0	0	0	0	0	0	0	0	0	0	0	0	0	0	0
Katie Bridges	TCU	Oct. 22, 2016	Murray St.	0	0	0	0	0	0	0	0	0	0	0	0	0	0	0	0
Rachel Garner	TCU	Oct. 22, 2016	Murray St.	96	99	100	99	96	95	585	0	98	98	100	99	100	97	592	0
Ariana Grabowski	TCU	Oct. 22, 2016	Murray St.	97	98	100	100	96	96	587	0	96	95	97	95	99	98	580	0
Emily Haag	TCU	Oct. 22, 2016	Murray St.	96	91	97	98	87	87	556	0	92	94	95	93	98	96	568	0
Nicole Hankey	TCU	Oct. 22, 2016	Murray St.	97	95	97	99	94	95	577	0	100	98	98	98	99	98	591	0
Rachel Kimbell	TCU	Oct. 22, 2016	Murray St.	95	95	99	99	95	91	574	0	96	96	91	92	96	97	568	0
Sally Li	TCU	Oct. 22, 2016	Murray St.	96	97	100	99	97	97	586	0	99	99	100	99	100	99	596	0
Casey Lutz	TCU	Oct. 22, 2016	Murray St.	98	96	99	100	93	100	586	0	95	97	98	98	99	97	584	0
Mindy Miles	TCU	Oct. 22, 2016	Murray St.	100	94	99	100	97	96	586	0	100	100	99	99	99	99	596	0
Catherine Miller	TCU	Oct. 22, 2016	Murray St.	95	97	99	98	95	94	578	0	97	100	98	99	98	99	591	0
Meraleigh Randle	TCU	Oct. 22, 2016	Murray St.	0	0	0	0	0	0	0	0	0	0	0	0	0	0	0	0
Barrett Ray	TCU	Oct. 22, 2016	Murray St.	93	94	96	98	95	99	575	0	100	97	99	99	100	98	593	0
Hunter Behrends	Jacksonville St.	Oct. 22, 2016	Murray St.	0	0	0	0	0	0	0	0	0	0	0	0	0	0	0	0
Austin Cock	Jacksonville St.	Oct. 22, 2016	Murray St.	94	95	98	96	91	89	563	0	98	98	93	94	95	95	573	0
Anika Corsi	Jacksonville St.	Oct. 22, 2016	Murray St.	0	0	0	0	0	0	0	0	0	0	0	0	0	0	0	0
Trace Haynes	Jacksonville St.	Oct. 22, 2016	Murray St.	96	97	98	99	94	96	580	0	97	96	97	100	97	95	582	0
Brandon Henson	Jacksonville St.	Oct. 22, 2016	Murray St.	0	0	0	0	0	0	0	0	0	0	0	0	0	0	0	0
Brandon Muske	Jacksonville St.	Oct. 22, 2016	Murray St.	95	98	95	97	94	99	578	0	99	98	99	99	98	98	591	0
Kyle Ordille	Jacksonville St.	Oct. 22, 2016	Murray St.	0	0	0	0	0	0	0	0	0	0	0	0	0	0	0	0
Carleigh Peters	Jacksonville St.	Oct. 22, 2016	Murray St.	0	0	0	0	0	0	0	0	97	96	100	96	97	97	583	0
Garrett Rabel	Jacksonville St.	Oct. 22, 2016	Murray St.	98	91	100	98	90	92	569	0	97	96	98	96	98	96	581	0
Tyler Ramos	Jacksonville St.	Oct. 22, 2016	Murray St.	97	97	98	97	89	89	567	0	95	97	98	99	97	95	581	0
Mekenna Richardson	Jacksonville St.	Oct. 22, 2016	Murray St.	97	96	99	100	97	92	581	0	96	97	93	94	96	97	573	0
Carter Santrock	Jacksonville St.	Oct. 22, 2016	Murray St.	93	95	99	98	91	95	571	0	98	97	94	99	97	98	583	0
Zach Schmidt	Jacksonville St.	Oct. 22, 2016	Murray St.	98	95	98	97	94	92	574	0	98	99	94	97	94	96	578	0
David Sink	Jacksonville St.	Oct. 22, 2016	Murray St.	94	98	96	96	93	93	570	0	97	97	98	97	96	95	580	0
Angelica Dearaujo	John Jay	Oct. 22, 2016	USciences	92	87	96	88	91	93	547	0	94	97	96	95	94	96	572	0
Lily Graham	John Jay	Oct. 22, 2016	USciences	88	92	97	93	83	86	539	0	98	95	92	95	98	98	576	0
Ronald Kopec	John Jay	Oct. 22, 2016	USciences	91	91	92	94	78	86	532	0	95	96	91	94	92	90	558	0
Eliza Kotowska	John Jay	Oct. 22, 2016	USciences	0	0	0	0	0	0	0	0	80	80	92	83	89	94	518	0
Susana Sanchez	John Jay	Oct. 22, 2016	USciences	87	74	90	91	89	74	505	0	92	90	94	88	94	94	552	0
Ida Sato	John Jay	Oct. 22, 2016	USciences	85	79	82	88	82	81	497	0	88	92	91	93	88	87	539	0
Marc Suda	John Jay	Oct. 22, 2016	USciences	84	85	88	91	78	73	499	0	86	93	88	88	87	84	526	0
Rachel Hubal	USciences	Oct. 22, 2016	USciences	72	78	95	95	83	75	498	0	86	85	87	88	91	82	519	0
Angela Kang	USciences	Oct. 22, 2016	USciences	85	90	92	95	74	80	516	0	91	91	93	88	88	85	536	0
Brittany Mahoney	USciences	Oct. 22, 2016	USciences	66	74	77	75	38	30	360	0	0	0	0	0	0	0	0	0
Chris Makosiej	USciences	Oct. 22, 2016	USciences	69	79	83	80	59	66	436	0	66	75	83	83	77	84	468	0
Nick Makosiej	USciences	Oct. 22, 2016	USciences	56	66	81	77	62	50	392	0	0	0	0	0	0	0	0	0
Thomas Nelligan	USciences	Oct. 22, 2016	USciences	0	0	0	0	0	0	0	0	0	0	0	0	0	0	0	0
Matt Popowicz	USciences	Oct. 22, 2016	USciences	82	80	93	94	74	85	508	0	83	82	86	88	86	82	507	0
Andrej Quatrone	USciences	Oct. 22, 2016	USciences	84	82	96	89	55	72	478	0	84	78	83	87	79	83	494	0
Sarah Schnupp	USciences	Oct. 22, 2016	USciences	98	94	96	98	95	91	572	0	97	94	94	93	93	95	566	0
Lauren Stabler	USciences	Oct. 22, 2016	USciences	86	82	69	71	0	0	308	0	87	87	93	92	84	84	527	0
Christina Tipton	USciences	Oct. 22, 2016	USciences	63	63	84	84	53	36	383	0	0	0	0	0	0	0	0	0
Allie Tuman	USciences	Oct. 22, 2016	USciences	92	88	91	93	86	80	530	0	86	82	90	86	91	87	522	0
Anita Varkey	USciences	Oct. 22, 2016	USciences	61	59	83	91	64	64	422	0	0	0	0	0	0	0	0	0
Andrew Visconti	USciences	Oct. 22, 2016	USciences	91	87	95	99	77	86	535	0	91	90	92	92	89	91	545	0
Nick Zsoldos	USciences	Oct. 22, 2016	USciences	87	93	92	92	84	87	535	0	86	88	87	90	90	91	532	0
Seth Baker	Morehead St.	Oct. 22, 2016	Ole Miss	96	96	93	99	90	90	564	18	97	95	99	96	96	95	578	29
Brandon Bryer	Morehead St.	Oct. 22, 2016	Ole Miss	95	98	98	100	95	92	578	27	97	94	98	95	95	100	579	35
Siarra Crum	Morehead St.	Oct. 22, 2016	Ole Miss	93	83	94	97	89	92	548	13	98	91	94	96	97	94	570	22
Sarah Fink	Morehead St.	Oct. 22, 2016	Ole Miss	97	93	98	98	93	90	569	23	97	98	97	94	98	98	582	35
Joe Fischer	Morehead St.	Oct. 22, 2016	Ole Miss	96	99	99	100	86	91	571	29	93	93	97	97	96	94	570	21
Dan Hall	Morehead St.	Oct. 22, 2016	Ole Miss	95	97	99	98	91	92	572	22	96	96	95	98	99	95	579	31
Jesse Moyer	Morehead St.	Oct. 22, 2016	Ole Miss	97	99	94	97	91	91	569	21	97	98	94	96	98	97	580	29
Alexa Potts	Morehead St.	Oct. 22, 2016	Ole Miss	95	96	98	96	91	92	568	13	96	96	99	94	97	99	581	37
Karly Potts	Morehead St.	Oct. 22, 2016	Ole Miss	96	95	97	95	88	89	560	18	95	98	100	96	99	98	586	36
Melanie West	Morehead St.	Oct. 22, 2016	Ole Miss	92	91	98	97	88	89	555	19	96	97	98	99	88	96	574	31
Haley Wilson	Morehead St.	Oct. 22, 2016	Ole Miss	95	89	95	97	95	92	563	19	98	96	95	97	96	98	580	30
Hayley Carroll	Ole Miss	Oct. 22, 2016	Ole Miss	93	94	99	97	94	95	572	21	100	96	100	95	96	95	582	30
Harley Gardner	Ole Miss	Oct. 22, 2016	Ole Miss	94	94	99	99	97	96	579	30	100	98	97	98	99	100	592	43
Jess Haig	Ole Miss	Oct. 22, 2016	Ole Miss	96	95	97	100	96	94	578	25	98	96	99	97	96	97	583	39
Alana Kelly	Ole Miss	Oct. 22, 2016	Ole Miss	96	93	100	98	95	88	570	21	95	98	97	95	99	96	580	32
Randi Loudin	Ole Miss	Oct. 22, 2016	Ole Miss	93	95	99	99	90	87	563	16	92	96	95	93	88	94	558	20
Marina Noble	Ole Miss	Oct. 22, 2016	Ole Miss	96	95	97	100	96	93	577	28	0	0	0	0	0	0	0	0
Samantha Sandifer	Ole Miss	Oct. 22, 2016	Ole Miss	91	92	99	97	89	89	557	19	94	96	98	99	98	95	580	34
Kristyn Trump	Ole Miss	Oct. 22, 2016	Ole Miss	97	96	98	96	94	89	570	20	97	98	96	96	99	95	581	33
Jillian Tyler	Ole Miss	Oct. 22, 2016	Ole Miss	94	96	98	98	92	90	568	21	96	97	97	95	99	100	584	35
Ali Weisz	Ole Miss	Oct. 22, 2016	Ole Miss	88	94	99	100	96	91	568	21	98	98	99	98	99	98	590	44
Spencer Brandon	Air Force	Oct. 22, 2016	Air Force	93	93	100	99	92	92	569	0	96	99	99	98	96	98	586	0
Spencer Cap	Air Force	Oct. 22, 2016	Air Force	97	95	97	97	92	94	572	0	100	99	100	98	100	100	597	0
Kyle Cox	Air Force	Oct. 22, 2016	Air Force	86	90	97	96	88	86	543	0	95	96	95	95	91	93	565	0
Ryan Jacobs	Air Force	Oct. 22, 2016	Air Force	94	98	99	100	93	97	581	0	99	97	99	98	98	98	589	0
Noah Kwock	Air Force	Oct. 22, 2016	Air Force	0	0	0	0	0	0	0	0	0	0	0	0	0	0	0	0
Nick Learn	Air Force	Oct. 22, 2016	Air Force	95	96	99	98	89	95	572	0	96	99	99	97	98	100	589	0
Logan Ogden	Air Force	Oct. 22, 2016	Air Force	96	96	100	100	92	92	576	0	98	99	98	100	97	98	590	0
Mary Simonton	Air Force	Oct. 22, 2016	Air Force	0	0	0	0	0	0	0	0	0	0	0	0	0	0	0	0
Anna Weilbacher	Air Force	Oct. 22, 2016	Air Force	96	95	99	99	94	96	579	0	97	97	98	100	98	99	589	0
Rachel Benesh	Nevada	Oct. 22, 2016	Air Force	94	96	96	92	91	95	564	0	100	97	94	96	97	96	580	0
Emily Capaul	Nevada	Oct. 22, 2016	Air Force	94	94	99	99	93	93	572	0	98	94	99	98	97	97	583	0
Jared Crews	Nevada	Oct. 22, 2016	Air Force	0	0	0	0	0	0	0	0	0	0	0	0	0	0	0	0
Maneva Gill	Nevada	Oct. 22, 2016	Air Force	0	0	0	0	0	0	0	0	0	0	0	0	0	0	0	0
Sarah Jameson	Nevada	Oct. 22, 2016	Air Force	92	95	97	97	91	97	569	0	100	97	98	99	99	97	590	0
Eli Larimer	Nevada	Oct. 22, 2016	Air Force	96	97	97	97	92	90	569	0	99	95	95	98	95	98	580	0
Justin Nissen	Nevada	Oct. 22, 2016	Air Force	98	94	99	97	92	92	572	0	97	96	99	98	99	98	587	0
Jami Sexton	Nevada	Oct. 22, 2016	Air Force	0	0	0	0	0	0	0	0	0	0	0	0	0	0	0	0
Sara Tashima	Nevada	Oct. 22, 2016	Air Force	0	0	0	0	0	0	0	0	0	0	0	0	0	0	0	0
Mitchell Van Patten	Nevada	Oct. 22, 2016	Air Force	96	96	99	98	97	96	582	0	98	99	99	98	99	98	591	0
Jessica Kinder	UTEP	Oct. 22, 2016	Air Force	0	0	0	0	0	0	0	0	99	100	98	99	97	97	590	0
Abby Monique	UTEP	Oct. 22, 2016	Air Force	97	95	99	100	93	92	576	0	96	94	99	99	99	98	585	0
Maranda Nelson	UTEP	Oct. 22, 2016	Air Force	93	96	97	97	94	90	567	0	94	98	96	98	94	100	580	0
Bailey Powell	UTEP	Oct. 22, 2016	Air Force	96	95	98	98	91	91	569	0	98	95	97	97	99	97	583	0
Mara Rouse	UTEP	Oct. 22, 2016	Air Force	93	94	96	98	91	94	566	0	96	96	98	95	97	98	580	0
Rachael Schoenrock	UTEP	Oct. 22, 2016	Air Force	93	96	97	99	92	92	569	0	98	96	95	98	98	99	584	0
Haylee Schoenrock	UTEP	Oct. 22, 2016	Air Force	94	97	98	96	89	91	565	0	96	97	96	97	94	98	578	0
Monthserrat Serna	UTEP	Oct. 22, 2016	Air Force	0	0	0	0	0	0	0	0	0	0	0	0	0	0	0	0
Allison Auten	Citadel	Oct. 22, 2016	North Georgia	87	91	93	98	91	89	549	0	93	92	95	93	99	99	571	0
Matthew Davenport	Citadel	Oct. 22, 2016	North Georgia	0	0	0	0	0	0	0	0	93	92	93	96	96	91	561	0
Joseph Ferguson	Citadel	Oct. 22, 2016	North Georgia	0	0	0	0	0	0	0	0	0	0	0	0	0	0	0	0
Morgan Long	Citadel	Oct. 22, 2016	North Georgia	85	93	98	97	92	89	554	0	99	93	96	97	97	98	580	0
Alexander McAlear	Citadel	Oct. 22, 2016	North Georgia	88	90	95	97	88	87	545	0	92	93	94	96	94	94	563	0
Patrick Meyer	Citadel	Oct. 22, 2016	North Georgia	92	91	96	96	81	83	539	0	0	0	0	0	0	0	0	0
Richie Parra	Citadel	Oct. 22, 2016	North Georgia	88	84	87	93	86	84	522	0	97	97	96	95	94	94	573	0
Colton Poole	Citadel	Oct. 22, 2016	North Georgia	90	93	95	92	90	86	546	0	95	95	94	97	96	92	569	0
Tommy Simrill	Citadel	Oct. 22, 2016	North Georgia	0	0	0	0	0	0	0	0	0	0	0	0	0	0	0	0
Andrew Abernathy	North Georgia	Oct. 22, 2016	North Georgia	92	92	99	91	94	97	565	0	94	93	96	92	97	94	566	0
Eric Azotea	North Georgia	Oct. 22, 2016	North Georgia	0	0	0	0	0	0	0	0	0	0	0	0	0	0	0	0
Ruthanne Conner	North Georgia	Oct. 22, 2016	North Georgia	93	93	99	99	95	89	568	0	97	96	95	97	98	98	581	0
Lucas Gilliland	North Georgia	Oct. 22, 2016	North Georgia	86	87	97	98	87	87	542	0	96	94	94	96	96	96	572	0
Maddie Godwin	North Georgia	Oct. 22, 2016	North Georgia	0	0	0	0	0	0	0	0	0	0	0	0	0	0	0	0
Hannah Peevy	North Georgia	Oct. 22, 2016	North Georgia	0	0	0	0	0	0	0	0	0	0	0	0	0	0	0	0
Jared Rice	North Georgia	Oct. 22, 2016	North Georgia	89	94	97	96	92	88	556	0	100	95	93	92	94	94	568	0
Tobin Sanctuary	North Georgia	Oct. 22, 2016	North Georgia	96	97	97	97	88	90	565	0	89	91	98	95	96	94	563	0
Brianna Shaw	North Georgia	Oct. 22, 2016	North Georgia	0	0	0	0	0	0	0	0	0	0	0	0	0	0	0	0
Dakota Spivey	North Georgia	Oct. 22, 2016	North Georgia	96	96	94	97	87	92	562	0	99	100	97	98	100	100	594	0
David Turner	North Georgia	Oct. 22, 2016	North Georgia	90	92	97	97	85	86	547	0	93	96	97	98	95	98	577	0
Sarah Banks	Alabama Birmingham	Oct. 22, 2016	North Georgia	0	0	0	0	0	0	0	0	0	0	0	0	0	0	0	0
Steven Bugg	Alabama Birmingham	Oct. 22, 2016	North Georgia	0	0	0	0	0	0	0	0	90	88	93	94	88	86	539	0
Selina Curren	Alabama Birmingham	Oct. 22, 2016	North Georgia	0	0	0	0	0	0	0	0	0	0	0	0	0	0	0	0
Lindsey Hill	Alabama Birmingham	Oct. 22, 2016	North Georgia	0	0	0	0	0	0	0	0	0	0	0	0	0	0	0	0
Isaac King	Alabama Birmingham	Oct. 22, 2016	North Georgia	0	0	0	0	0	0	0	0	0	0	0	0	0	0	0	0
Kristie Lloyd	Alabama Birmingham	Oct. 22, 2016	North Georgia	0	0	0	0	0	0	0	0	93	94	91	88	90	82	538	0
Logan Short	Alabama Birmingham	Oct. 22, 2016	North Georgia	0	0	0	0	0	0	0	0	0	0	0	0	0	0	0	0
Mallory Sisk	Alabama Birmingham	Oct. 22, 2016	North Georgia	0	0	0	0	0	0	0	0	0	0	0	0	0	0	0	0
Micah Smith	Alabama Birmingham	Oct. 22, 2016	North Georgia	0	0	0	0	0	0	0	0	0	0	0	0	0	0	0	0
Emily Stover	Alabama Birmingham	Oct. 22, 2016	North Georgia	0	0	0	0	0	0	0	0	90	95	92	88	95	92	552	0
Ella Von Canon	Alabama Birmingham	Oct. 22, 2016	North Georgia	0	0	0	0	0	0	0	0	0	0	0	0	0	0	0	0
Lilly Vonderau	Alabama Birmingham	Oct. 22, 2016	North Georgia	0	0	0	0	0	0	0	0	98	96	96	96	94	99	579	0
Rosemary Kramer	Ga. Southern	Oct. 22, 2016	North Georgia	92	96	97	96	91	92	564	0	95	92	97	96	95	92	567	0
Tori Lewis	Ga. Southern	Oct. 22, 2016	North Georgia	89	88	97	94	91	92	551	0	95	98	93	97	93	98	574	0
Jennifer Middlebrook	Ga. Southern	Oct. 22, 2016	North Georgia	0	0	0	0	0	0	0	0	0	0	0	0	0	0	0	0
Lydia Odlin	Ga. Southern	Oct. 22, 2016	North Georgia	89	87	94	93	82	79	524	0	94	89	94	87	91	96	551	0
Chastity Price	Ga. Southern	Oct. 22, 2016	North Georgia	91	84	86	94	83	84	522	0	92	93	92	92	91	93	553	0
Courtney Weekley	Ga. Southern	Oct. 22, 2016	North Georgia	89	89	97	96	93	90	554	0	98	94	100	97	96	95	580	0
Kathryn Youngblood	Ga. Southern	Oct. 22, 2016	North Georgia	0	0	0	0	0	0	0	0	0	0	0	0	0	0	0	0
Carli Cline	Citadel (W)	Oct. 22, 2016	North Georgia	79	80	93	89	63	81	485	0	0	0	0	0	0	0	0	0
Brandi Duzz	Citadel (W)	Oct. 22, 2016	North Georgia	78	73	93	95	78	83	500	0	90	89	89	90	90	91	539	0
Leah Fenwrick-Wallace	Citadel (W)	Oct. 22, 2016	North Georgia	90	88	92	95	82	84	531	0	95	93	93	92	95	95	563	0
Shadonna Littlejohn	Citadel (W)	Oct. 22, 2016	North Georgia	0	0	0	0	0	0	0	0	91	88	84	88	84	86	521	0
Tierra Price	Citadel (W)	Oct. 22, 2016	North Georgia	0	0	0	0	0	0	0	0	0	0	0	0	0	0	0	0
Faith Totherow	Citadel (W)	Oct. 22, 2016	North Georgia	87	95	94	96	82	91	545	0	85	88	90	86	81	87	517	0
Raven Wills	Citadel (W)	Oct. 22, 2016	North Georgia	0	0	0	0	0	0	0	0	0	0	0	0	0	0	0	0
Spencer Brandon	Air Force	Oct. 23, 2016	Air Force	94	95	97	98	92	95	571	0	100	98	99	100	98	97	592	0
Spencer Cap	Air Force	Oct. 23, 2016	Air Force	98	96	100	100	92	97	583	0	99	99	97	98	99	100	592	0
Kyle Cox	Air Force	Oct. 23, 2016	Air Force	84	81	95	98	79	86	523	0	87	97	91	94	90	92	551	0
Ryan Jacobs	Air Force	Oct. 23, 2016	Air Force	100	98	100	99	97	94	588	0	98	99	99	100	100	99	595	0
Noah Kwock	Air Force	Oct. 23, 2016	Air Force	0	0	0	0	0	0	0	0	0	0	0	0	0	0	0	0
Nick Learn	Air Force	Oct. 23, 2016	Air Force	96	96	96	96	91	90	565	0	96	100	98	97	99	98	588	0
Logan Ogden	Air Force	Oct. 23, 2016	Air Force	97	98	97	99	93	97	581	0	98	99	98	98	99	100	592	0
Mary Simonton	Air Force	Oct. 23, 2016	Air Force	0	0	0	0	0	0	0	0	0	0	0	0	0	0	0	0
Anna Weilbacher	Air Force	Oct. 23, 2016	Air Force	96	95	98	100	93	91	573	0	99	98	99	100	99	97	592	0
Rachel Benesh	Nevada	Oct. 23, 2016	Air Force	91	91	97	96	96	93	564	0	99	98	98	98	96	97	586	0
Emily Capaul	Nevada	Oct. 23, 2016	Air Force	92	95	98	97	96	94	572	0	99	98	100	99	96	97	589	0
Jared Crews	Nevada	Oct. 23, 2016	Air Force	0	0	0	0	0	0	0	0	0	0	0	0	0	0	0	0
Maneva Gill	Nevada	Oct. 23, 2016	Air Force	0	0	0	0	0	0	0	0	0	0	0	0	0	0	0	0
Sarah Jameson	Nevada	Oct. 23, 2016	Air Force	96	94	100	97	91	95	573	0	98	97	99	99	96	95	584	0
Eli Larimer	Nevada	Oct. 23, 2016	Air Force	97	97	98	97	91	95	575	0	97	96	97	95	97	98	580	0
Justin Nissen	Nevada	Oct. 23, 2016	Air Force	94	94	98	98	90	93	567	0	96	96	98	96	99	96	581	0
Jami Sexton	Nevada	Oct. 23, 2016	Air Force	0	0	0	0	0	0	0	0	0	0	0	0	0	0	0	0
Sara Tashima	Nevada	Oct. 23, 2016	Air Force	0	0	0	0	0	0	0	0	0	0	0	0	0	0	0	0
Mitchell Van Patten	Nevada	Oct. 23, 2016	Air Force	98	97	99	99	97	94	584	0	98	99	98	99	100	97	591	0
Jessica Kinder	UTEP	Oct. 23, 2016	Air Force	0	0	0	0	0	0	0	0	98	98	97	96	99	97	585	0
Abby Monique	UTEP	Oct. 23, 2016	Air Force	95	98	97	99	92	94	575	0	99	98	97	97	98	97	586	0
Maranda Nelson	UTEP	Oct. 23, 2016	Air Force	95	93	95	98	90	91	562	0	93	93	94	93	97	92	562	0
Bailey Powell	UTEP	Oct. 23, 2016	Air Force	98	91	99	100	89	91	568	0	98	97	99	97	96	97	584	0
Mara Rouse	UTEP	Oct. 23, 2016	Air Force	95	96	95	97	89	86	558	0	99	95	98	96	98	97	583	0
Rachael Schoenrock	UTEP	Oct. 23, 2016	Air Force	95	94	98	97	96	96	576	0	98	98	98	99	99	94	586	0
Haylee Schoenrock	UTEP	Oct. 23, 2016	Air Force	96	94	94	99	91	98	572	0	97	92	95	94	91	97	566	0
Monthserrat Serna	UTEP	Oct. 23, 2016	Air Force	0	0	0	0	0	0	0	0	0	0	0	0	0	0	0	0
Deanna Binnie	Ohio State	Oct. 23, 2016	Ohio State	94	94	96	99	90	89	562	0	95	97	97	96	98	97	580	0
Josh Black	Ohio State	Oct. 23, 2016	Ohio State	95	98	99	99	95	97	583	0	96	98	98	96	100	97	585	0
Jacob Buchanan	Ohio State	Oct. 23, 2016	Ohio State	97	96	97	97	91	93	571	0	98	99	99	97	98	98	589	0
Drew Cheezum	Ohio State	Oct. 23, 2016	Ohio State	96	98	99	98	95	95	581	0	98	100	98	98	98	96	588	0
Anthony Cuozzo	Ohio State	Oct. 23, 2016	Ohio State	99	98	97	100	95	94	583	0	95	96	97	97	98	96	579	0
Kendal Elder	Ohio State	Oct. 23, 2016	Ohio State	96	95	100	99	93	94	577	0	95	96	95	97	97	99	579	0
Alli Kissell	Ohio State	Oct. 23, 2016	Ohio State	97	97	98	95	94	91	572	0	97	97	98	96	97	99	584	0
Mark Matheny	Ohio State	Oct. 23, 2016	Ohio State	94	94	99	100	95	93	575	0	98	98	97	99	95	97	584	0
Patrick Sardo	Ohio State	Oct. 23, 2016	Ohio State	92	93	96	96	83	90	550	0	89	95	94	94	92	95	559	0
Michael Steinel	Ohio State	Oct. 23, 2016	Ohio State	94	93	99	98	96	93	573	0	98	97	98	89	97	98	577	0
Chrissy Thomas	Ohio State	Oct. 23, 2016	Ohio State	95	93	98	99	88	89	562	0	96	98	96	99	97	98	584	0
Rhiann Travis	Ohio State	Oct. 23, 2016	Ohio State	96	94	99	98	95	93	575	0	98	99	98	100	100	99	594	0
Bailey Urbach	Ohio State	Oct. 23, 2016	Ohio State	93	93	95	99	93	90	563	0	96	94	96	90	99	94	569	0
Brendan Whitaker	Ohio State	Oct. 23, 2016	Ohio State	95	96	99	97	93	92	572	0	94	98	99	98	94	99	582	0
Quintin Wotring	Ohio State	Oct. 23, 2016	Ohio State	90	93	98	100	93	94	568	0	98	95	96	96	96	92	573	0
Jack Anderson	West Virginia	Oct. 23, 2016	Ohio State	94	90	100	98	93	94	569	0	97	96	97	97	93	99	579	0
Will Anti	West Virginia	Oct. 23, 2016	Ohio State	92	97	98	100	96	93	576	0	98	98	96	93	97	100	582	0
Milica Babic	West Virginia	Oct. 23, 2016	Ohio State	92	97	99	100	96	94	578	0	98	99	99	100	100	100	596	0
Noah Barker	West Virginia	Oct. 23, 2016	Ohio State	0	0	0	0	0	0	0	0	0	0	0	0	0	0	0	0
Elizabeth Gratz	West Virginia	Oct. 23, 2016	Ohio State	96	97	97	100	95	96	581	0	97	100	100	99	99	100	595	0
Jean-Pierre Lucas	West Virginia	Oct. 23, 2016	Ohio State	97	98	99	100	95	96	585	0	96	99	99	99	97	100	590	0
Morgan Phillips	West Virginia	Oct. 23, 2016	Ohio State	98	95	100	99	94	99	585	0	100	98	99	100	98	98	593	0
Ginny Thrasher	West Virginia	Oct. 23, 2016	Ohio State	98	96	100	100	100	96	590	0	100	100	100	100	99	100	599	0
Lauryn Cinadr	Akron	Oct. 23, 2016	Akron	90	90	94	93	87	90	544	10	97	95	93	98	97	99	579	32
Alex Fedorko	Akron	Oct. 23, 2016	Akron	89	88	98	97	85	85	542	11	87	94	93	91	90	94	549	13
Sydney Goldschlag	Akron	Oct. 23, 2016	Akron	99	94	98	96	90	88	565	23	95	94	95	96	96	98	574	24
Rebecca Green	Akron	Oct. 23, 2016	Akron	96	91	97	97	87	86	554	16	96	97	92	94	96	93	568	25
Julia Hatch	Akron	Oct. 23, 2016	Akron	96	96	98	98	93	96	577	30	97	96	94	98	94	95	574	23
Anthony Jackson	Akron	Oct. 23, 2016	Akron	98	96	100	100	94	92	580	34	93	99	97	100	99	96	584	32
Kera Kaufman	Akron	Oct. 23, 2016	Akron	91	95	96	95	87	86	550	13	96	96	94	95	94	94	569	27
Joshua Kovach	Akron	Oct. 23, 2016	Akron	91	90	97	98	90	94	560	14	98	96	96	100	98	95	583	38
Caleb Lloyd	Akron	Oct. 23, 2016	Akron	98	98	99	100	92	91	578	33	96	97	98	100	95	95	581	28
Danielle Makucevich	Akron	Oct. 23, 2016	Akron	0	0	0	0	0	0	0	0	93	93	91	97	96	94	564	19
Kris Mantel	Akron	Oct. 23, 2016	Akron	90	90	92	92	89	84	537	11	95	96	93	94	95	93	566	20
Brent Morgan	Akron	Oct. 23, 2016	Akron	0	0	0	0	0	0	0	0	90	93	92	94	88	90	547	12
Connor O'Mara	Akron	Oct. 23, 2016	Akron	90	95	98	96	86	92	557	19	98	99	98	97	99	98	589	36
Marlee Reynolds	Akron	Oct. 23, 2016	Akron	89	91	98	94	83	87	542	19	94	90	88	89	93	90	544	12
Sean Roehrs	Akron	Oct. 23, 2016	Akron	93	96	95	94	88	88	554	17	93	92	94	92	94	94	559	14
Zach Strohl	Akron	Oct. 23, 2016	Akron	96	100	99	100	90	96	581	36	98	96	98	98	98	100	588	35
Cierra Terrizzi	Akron	Oct. 23, 2016	Akron	94	90	99	98	91	94	566	26	95	86	92	96	94	96	559	20
Zach Eisenberg	North Carolina St.	Oct. 23, 2016	Akron	89	91	98	93	90	89	550	12	95	98	96	98	96	95	578	33
Caitlyn Ford	North Carolina St.	Oct. 23, 2016	Akron	98	96	95	97	91	94	571	25	94	98	93	94	93	96	568	23
Sarah Hickey	North Carolina St.	Oct. 23, 2016	Akron	0	0	0	0	0	0	0	0	0	0	0	0	0	0	0	0
Lucas Kozeniesky	North Carolina St.	Oct. 23, 2016	Akron	96	97	97	98	92	94	574	27	97	100	100	99	100	99	595	51
Tyler Lefebvre	North Carolina St.	Oct. 23, 2016	Akron	87	93	92	94	88	92	546	14	93	93	96	93	96	97	568	22
Will Marciniak	North Carolina St.	Oct. 23, 2016	Akron	96	98	99	99	93	94	579	28	98	98	95	98	94	94	577	28
Derya Pekari	North Carolina St.	Oct. 23, 2016	Akron	94	92	98	98	89	91	562	20	99	100	98	98	96	97	588	37
Lauren Phillips	North Carolina St.	Oct. 23, 2016	Akron	93	95	98	95	96	97	574	27	96	98	100	99	99	99	591	41
Claire Spina	North Carolina St.	Oct. 23, 2016	Akron	0	0	0	0	0	0	0	0	0	0	0	0	0	0	0	0
Cullen Wargo	North Carolina St.	Oct. 23, 2016	Akron	0	0	0	0	0	0	0	0	0	0	0	0	0	0	0	0
George Williams	North Carolina St.	Oct. 23, 2016	Akron	0	0	0	0	0	0	0	0	0	0	0	0	0	0	0	0
Claire Zanti	North Carolina St.	Oct. 23, 2016	Akron	89	86	95	97	89	95	551	18	100	96	99	97	98	98	588	37
Allison Auten	Citadel	Oct. 29, 2016	Citadel	87	87	95	91	90	92	542	0	96	97	97	99	94	98	581	0
Matthew Davenport	Citadel	Oct. 29, 2016	Citadel	87	87	92	94	80	81	521	0	93	93	95	96	89	94	560	0
Joseph Ferguson	Citadel	Oct. 29, 2016	Citadel	79	87	93	93	86	74	512	0	92	92	93	90	97	92	556	0
Morgan Long	Citadel	Oct. 29, 2016	Citadel	86	75	94	95	91	90	531	0	95	96	96	97	96	92	572	0
Alexander McAlear	Citadel	Oct. 29, 2016	Citadel	87	90	94	96	86	86	539	0	97	96	97	96	96	93	575	0
Patrick Meyer	Citadel	Oct. 29, 2016	Citadel	89	84	98	98	83	79	531	0	92	91	90	92	94	94	553	0
Richie Parra	Citadel	Oct. 29, 2016	Citadel	88	89	95	97	91	92	552	0	95	93	95	96	93	93	565	0
Colton Poole	Citadel	Oct. 29, 2016	Citadel	91	99	96	95	93	93	567	0	96	95	94	94	96	94	569	0
Tommy Simrill	Citadel	Oct. 29, 2016	Citadel	87	85	93	92	84	71	512	0	90	88	89	86	95	94	542	0
Lucas Figi	Navy	Oct. 29, 2016	Citadel	0	0	0	0	0	0	0	0	0	0	0	0	0	0	0	0
Maggie Guetersloh	Navy	Oct. 29, 2016	Citadel	0	0	0	0	0	0	0	0	0	0	0	0	0	0	0	0
Amy Hammer	Navy	Oct. 29, 2016	Citadel	0	0	0	0	0	0	0	0	0	0	0	0	0	0	0	0
Daniel Jonas	Navy	Oct. 29, 2016	Citadel	96	97	99	99	94	95	580	0	99	98	97	98	99	96	587	0
Kestrel Kuhne	Navy	Oct. 29, 2016	Citadel	0	0	0	0	0	0	0	0	0	0	0	0	0	0	0	0
Alex Muzzioli	Navy	Oct. 29, 2016	Citadel	96	92	96	95	90	92	561	0	97	96	91	93	97	95	569	0
Brandon Pippin	Navy	Oct. 29, 2016	Citadel	0	0	0	0	0	0	0	0	99	92	93	96	95	95	570	0
Nash Richardson	Navy	Oct. 29, 2016	Citadel	97	97	99	97	92	95	577	0	0	0	0	0	0	0	0	0
Thomas Sarant	Navy	Oct. 29, 2016	Citadel	93	94	100	98	95	95	575	0	98	96	99	98	99	96	586	0
Josh Watson	Navy	Oct. 29, 2016	Citadel	95	94	98	99	92	94	572	0	96	97	93	98	96	98	578	0
Zach Eisenberg	North Carolina St.	Oct. 29, 2016	Citadel	95	95	98	99	91	93	571	0	96	98	97	99	98	96	584	0
Caitlyn Ford	North Carolina St.	Oct. 29, 2016	Citadel	94	91	97	97	94	91	564	0	98	97	97	98	97	96	583	6
Sarah Hickey	North Carolina St.	Oct. 29, 2016	Citadel	95	95	97	97	94	91	569	0	96	98	95	96	93	96	574	0
Lucas Kozeniesky	North Carolina St.	Oct. 29, 2016	Citadel	96	96	100	99	97	98	586	0	97	100	100	100	99	100	596	0
Tyler Lefebvre	North Carolina St.	Oct. 29, 2016	Citadel	91	94	97	97	90	89	558	0	98	96	97	96	95	96	578	0
Will Marciniak	North Carolina St.	Oct. 29, 2016	Citadel	93	97	99	97	89	90	565	0	97	96	96	96	99	92	576	0
Derya Pekari	North Carolina St.	Oct. 29, 2016	Citadel	96	94	100	97	91	89	567	0	99	98	94	99	96	99	585	0
Lauren Phillips	North Carolina St.	Oct. 29, 2016	Citadel	94	98	97	95	99	96	579	0	99	98	99	99	99	100	594	0
Claire Spina	North Carolina St.	Oct. 29, 2016	Citadel	89	89	92	96	92	90	548	0	94	99	98	95	97	96	579	0
Cullen Wargo	North Carolina St.	Oct. 29, 2016	Citadel	92	89	98	97	90	89	555	0	95	94	97	94	96	96	572	0
George Williams	North Carolina St.	Oct. 29, 2016	Citadel	91	93	94	96	84	87	545	0	94	95	95	89	96	97	566	0
Claire Zanti	North Carolina St.	Oct. 29, 2016	Citadel	95	93	97	94	94	97	570	0	97	99	96	97	96	97	582	0
Carli Cline	Citadel (W)	Oct. 29, 2016	Citadel	0	0	0	0	0	0	0	0	0	0	0	0	0	0	0	0
Brandi Duzz	Citadel (W)	Oct. 29, 2016	Citadel	76	63	88	91	80	70	468	0	92	94	95	90	90	97	558	0
Leah Fenwrick-Wallace	Citadel (W)	Oct. 29, 2016	Citadel	85	86	89	92	83	89	524	0	89	95	95	93	95	93	560	0
Shadonna Littlejohn	Citadel (W)	Oct. 29, 2016	Citadel	82	79	85	90	55	65	456	0	90	93	93	86	86	93	541	0
Tierra Price	Citadel (W)	Oct. 29, 2016	Citadel	82	79	78	85	76	60	460	0	79	85	87	81	84	79	495	0
Faith Totherow	Citadel (W)	Oct. 29, 2016	Citadel	89	90	94	95	89	90	547	0	92	88	87	87	90	92	536	0
Raven Wills	Citadel (W)	Oct. 29, 2016	Citadel	81	84	89	89	80	74	497	0	86	83	90	87	94	85	525	0
Angelica Dearaujo	John Jay	Oct. 29, 2016	MIT	80	78	93	87	84	87	509	0	95	94	89	94	92	94	558	92
Lily Graham	John Jay	Oct. 29, 2016	MIT	92	92	95	97	91	91	558	0	92	95	95	91	96	97	566	0
Ronald Kopec	John Jay	Oct. 29, 2016	MIT	88	85	95	93	83	89	533	0	94	92	92	92	96	91	557	0
Eliza Kotowska	John Jay	Oct. 29, 2016	MIT	0	0	0	0	0	0	0	0	0	0	0	0	0	0	0	0
Susana Sanchez	John Jay	Oct. 29, 2016	MIT	76	65	85	79	75	69	449	0	84	90	90	91	87	88	530	0
Ida Sato	John Jay	Oct. 29, 2016	MIT	80	78	86	83	80	76	483	0	87	93	94	91	95	84	544	0
Marc Suda	John Jay	Oct. 29, 2016	MIT	83	85	92	95	80	75	510	0	87	89	87	89	88	88	528	0
William Caruso	MIT	Oct. 29, 2016	MIT	88	89	85	92	74	74	502	0	87	81	84	90	86	90	518	0
Efraim Helman	MIT	Oct. 29, 2016	MIT	0	0	0	0	0	0	0	0	0	0	0	0	0	0	0	0
Yaakov Helman	MIT	Oct. 29, 2016	MIT	0	0	0	0	0	0	0	0	0	0	0	0	0	0	0	0
Jesus Herrera	MIT	Oct. 29, 2016	MIT	94	92	87	84	67	74	498	0	82	87	88	88	90	85	520	0
Alexander Laiman	MIT	Oct. 29, 2016	MIT	0	0	0	0	0	0	0	0	81	65	0	0	0	0	146	0
Gregory Lee	MIT	Oct. 29, 2016	MIT	88	88	91	90	80	79	516	0	88	91	94	89	96	82	540	0
Kelly Mathesius	MIT	Oct. 29, 2016	MIT	88	89	96	98	89	87	547	0	91	90	92	94	92	93	552	0
Elijah Miller	MIT	Oct. 29, 2016	MIT	0	0	0	0	0	0	0	0	81	76	79	75	80	78	469	0
Dylan Modesitt	MIT	Oct. 29, 2016	MIT	90	91	96	93	72	82	524	0	88	88	80	91	84	92	523	0
Kevin Ng	MIT	Oct. 29, 2016	MIT	90	90	98	96	81	79	534	0	88	86	93	90	93	91	541	0
Alex Pacheco	MIT	Oct. 29, 2016	MIT	70	84	77	86	74	64	455	0	76	90	86	86	75	72	485	0
Kevin Petrovic	MIT	Oct. 29, 2016	MIT	84	86	90	94	57	71	482	0	80	77	80	80	80	81	478	0
Thomas Rick	MIT	Oct. 29, 2016	MIT	69	76	89	88	69	55	446	0	79	87	82	88	92	76	504	0
Joel Solis	MIT	Oct. 29, 2016	MIT	0	0	0	0	0	0	0	0	88	84	90	85	88	88	523	0
Seth Baker	Morehead St.	Oct. 29, 2016	Morehead St.	94	96	96	99	94	92	571	0	96	97	94	99	95	95	576	0
Brandon Bryer	Morehead St.	Oct. 29, 2016	Morehead St.	96	96	97	98	87	93	567	0	92	98	96	96	98	97	577	0
Siarra Crum	Morehead St.	Oct. 29, 2016	Morehead St.	91	91	96	97	93	89	557	0	95	97	98	97	99	98	584	0
Sarah Fink	Morehead St.	Oct. 29, 2016	Morehead St.	97	96	99	99	89	93	573	0	99	97	95	95	94	96	576	0
Joe Fischer	Morehead St.	Oct. 29, 2016	Morehead St.	96	98	99	100	89	83	565	0	97	96	96	97	98	95	579	0
Dan Hall	Morehead St.	Oct. 29, 2016	Morehead St.	94	93	99	98	90	89	563	0	90	94	96	93	98	95	566	0
Jesse Moyer	Morehead St.	Oct. 29, 2016	Morehead St.	95	96	93	96	90	92	562	0	99	98	96	99	99	95	586	0
Alexa Potts	Morehead St.	Oct. 29, 2016	Morehead St.	93	93	99	95	92	93	565	0	94	95	99	96	96	96	576	0
Karly Potts	Morehead St.	Oct. 29, 2016	Morehead St.	95	94	96	95	89	85	554	0	98	99	98	99	100	97	591	0
Melanie West	Morehead St.	Oct. 29, 2016	Morehead St.	89	94	98	97	86	90	554	0	96	95	96	97	98	96	578	0
Haley Wilson	Morehead St.	Oct. 29, 2016	Morehead St.	93	97	97	99	95	93	574	0	98	96	96	96	98	97	581	0
Andrew Abernathy	North Georgia	Oct. 29, 2016	Morehead St.	94	93	98	98	86	93	562	0	94	96	92	97	91	94	564	0
Eric Azotea	North Georgia	Oct. 29, 2016	Morehead St.	0	0	0	0	0	0	0	0	0	0	0	0	0	0	0	0
Ruthanne Conner	North Georgia	Oct. 29, 2016	Morehead St.	90	96	96	96	88	91	557	0	97	95	100	97	98	94	581	0
Lucas Gilliland	North Georgia	Oct. 29, 2016	Morehead St.	93	90	97	96	86	84	546	0	93	94	97	99	92	94	569	0
Maddie Godwin	North Georgia	Oct. 29, 2016	Morehead St.	0	0	0	0	0	0	0	0	0	0	0	0	0	0	0	0
Hannah Peevy	North Georgia	Oct. 29, 2016	Morehead St.	0	0	0	0	0	0	0	0	0	0	0	0	0	0	0	0
Jared Rice	North Georgia	Oct. 29, 2016	Morehead St.	92	95	97	99	88	96	567	0	97	96	99	95	96	95	578	0
Tobin Sanctuary	North Georgia	Oct. 29, 2016	Morehead St.	94	94	95	99	92	91	565	0	97	94	92	95	95	95	568	0
Brianna Shaw	North Georgia	Oct. 29, 2016	Morehead St.	0	0	0	0	0	0	0	0	0	0	0	0	0	0	0	0
Dakota Spivey	North Georgia	Oct. 29, 2016	Morehead St.	97	97	97	98	95	94	578	0	98	97	99	98	98	98	588	0
David Turner	North Georgia	Oct. 29, 2016	Morehead St.	0	0	0	0	0	0	0	0	0	0	0	0	0	0	0	0
Rachel Benesh	Nevada	Oct. 29, 2016	TCU	93	95	94	97	92	91	562	0	95	99	98	99	96	97	584	0
Emily Capaul	Nevada	Oct. 29, 2016	TCU	98	93	98	100	96	94	579	0	98	96	100	99	95	100	588	0
Jared Crews	Nevada	Oct. 29, 2016	TCU	0	0	0	0	0	0	0	0	0	0	0	0	0	0	0	0
Maneva Gill	Nevada	Oct. 29, 2016	TCU	0	0	0	0	0	0	0	0	0	0	0	0	0	0	0	0
Sarah Jameson	Nevada	Oct. 29, 2016	TCU	87	94	97	99	93	92	562	0	98	99	98	97	99	98	589	0
Eli Larimer	Nevada	Oct. 29, 2016	TCU	97	96	99	98	95	97	582	0	95	98	98	98	96	95	580	0
Justin Nissen	Nevada	Oct. 29, 2016	TCU	94	96	97	99	87	94	567	0	94	98	95	97	99	97	580	0
Jami Sexton	Nevada	Oct. 29, 2016	TCU	0	0	0	0	0	0	0	0	0	0	0	0	0	0	0	0
Sara Tashima	Nevada	Oct. 29, 2016	TCU	0	0	0	0	0	0	0	0	0	0	0	0	0	0	0	0
Mitchell Van Patten	Nevada	Oct. 29, 2016	TCU	96	96	100	99	96	98	585	33	98	99	98	98	99	99	591	44
Nicholle Benedict	TCU	Oct. 29, 2016	TCU	94	92	97	97	88	93	561	0	98	93	97	97	97	95	577	0
Katie Bridges	TCU	Oct. 29, 2016	TCU	92	97	99	99	84	95	566	0	91	96	96	99	95	96	573	0
Rachel Garner	TCU	Oct. 29, 2016	TCU	97	99	97	97	93	97	580	25	98	99	100	100	100	99	596	47
Ariana Grabowski	TCU	Oct. 29, 2016	TCU	97	99	98	100	96	90	580	30	99	97	96	96	99	96	583	0
Emily Haag	TCU	Oct. 29, 2016	TCU	90	94	99	98	85	87	553	0	96	98	94	97	95	95	575	0
Nicole Hankey	TCU	Oct. 29, 2016	TCU	95	95	99	98	94	94	575	0	98	97	99	98	99	98	589	0
Rachel Kimbell	TCU	Oct. 29, 2016	TCU	99	97	97	97	96	94	580	0	97	94	96	98	97	96	578	0
Sally Li	TCU	Oct. 29, 2016	TCU	97	97	100	98	98	94	584	31	100	100	98	98	99	97	592	45
Casey Lutz	TCU	Oct. 29, 2016	TCU	97	97	97	97	95	98	581	0	97	98	100	98	98	100	591	0
Mindy Miles	TCU	Oct. 29, 2016	TCU	96	97	99	100	96	99	587	0	98	100	100	100	100	99	597	0
Catherine Miller	TCU	Oct. 29, 2016	TCU	98	98	96	97	94	94	577	0	99	96	98	98	100	98	589	0
Meraleigh Randle	TCU	Oct. 29, 2016	TCU	0	0	0	0	0	0	0	0	92	92	97	94	94	93	562	0
Barrett Ray	TCU	Oct. 29, 2016	TCU	96	96	98	99	96	94	579	0	99	98	96	96	97	98	584	0
Nathan Brewer	Army	Oct. 29, 2016	Kentucky	94	91	97	100	98	95	575	0	97	96	98	95	98	98	582	0
Emiliano Concha-Toro	Army	Oct. 29, 2016	Kentucky	0	0	0	0	0	0	0	0	0	0	0	0	0	0	0	0
Ethan Cook	Army	Oct. 29, 2016	Kentucky	0	0	0	0	0	0	0	0	0	0	0	0	0	0	0	0
Danielle Cuomo	Army	Oct. 29, 2016	Kentucky	93	97	99	97	97	96	579	0	98	95	98	94	93	98	576	0
Maggie Ehmann	Army	Oct. 29, 2016	Kentucky	0	0	0	0	0	0	0	0	0	0	0	0	0	0	0	0
Maddy Erikson	Army	Oct. 29, 2016	Kentucky	88	93	98	98	87	96	560	0	97	97	98	98	98	96	584	0
Mike Garner	Army	Oct. 29, 2016	Kentucky	93	96	98	100	90	92	569	0	95	93	89	93	95	94	559	0
Nick Kanellis	Army	Oct. 29, 2016	Kentucky	0	0	0	0	0	0	0	0	0	0	0	0	0	0	0	0
Marvin Lewis	Army	Oct. 29, 2016	Kentucky	97	96	100	100	92	96	581	0	98	98	98	98	96	99	587	0
Rhianna Lichtenthal	Army	Oct. 29, 2016	Kentucky	0	0	0	0	0	0	0	0	0	0	0	0	0	0	0	0
Libby Mostert	Army	Oct. 29, 2016	Kentucky	0	0	0	0	0	0	0	0	0	0	0	0	0	0	0	0
Sarah Nakata	Army	Oct. 29, 2016	Kentucky	0	0	0	0	0	0	0	0	0	0	0	0	0	0	0	0
Payne Nunn	Army	Oct. 29, 2016	Kentucky	95	95	99	99	93	96	577	0	96	97	98	98	99	98	586	0
Allen Solida	Army	Oct. 29, 2016	Kentucky	0	0	0	0	0	0	0	0	0	0	0	0	0	0	0	0
Andrew Solomonides	Army	Oct. 29, 2016	Kentucky	0	0	0	0	0	0	0	0	0	0	0	0	0	0	0	0
Billy Azzinaro	Kentucky	Oct. 29, 2016	Kentucky	97	97	100	100	96	97	587	0	100	100	100	99	100	99	598	0
Jenna Bethea	Kentucky	Oct. 29, 2016	Kentucky	90	94	95	99	90	89	557	0	97	98	95	93	94	99	576	0
Hanna Carr	Kentucky	Oct. 29, 2016	Kentucky	99	96	100	100	97	98	590	0	96	99	97	97	96	96	581	0
Morgan Duerr	Kentucky	Oct. 29, 2016	Kentucky	92	96	100	95	88	85	556	0	94	98	96	98	97	96	579	0
Ian Foos	Kentucky	Oct. 29, 2016	Kentucky	94	93	93	98	91	93	562	0	96	98	98	96	98	95	581	0
Carmen Fry	Kentucky	Oct. 29, 2016	Kentucky	93	96	100	99	94	97	579	0	97	98	97	96	99	93	580	0
Heather Kirby	Kentucky	Oct. 29, 2016	Kentucky	97	96	100	99	92	93	577	0	100	99	99	98	98	99	593	0
Sonya May	Kentucky	Oct. 29, 2016	Kentucky	95	97	97	99	96	97	581	0	97	99	99	98	99	98	590	0
Andrew Miller	Kentucky	Oct. 29, 2016	Kentucky	92	90	95	99	87	92	555	0	96	97	95	97	93	97	575	0
Cathryn Papasodora	Kentucky	Oct. 29, 2016	Kentucky	90	96	99	100	93	95	573	0	99	95	98	99	97	100	588	0
Jason Scharbel	Kentucky	Oct. 29, 2016	Kentucky	93	94	99	99	95	88	568	0	97	99	98	96	95	97	582	0
Jason Spaude	Kentucky	Oct. 29, 2016	Kentucky	98	96	98	98	93	95	578	0	98	96	99	98	98	99	588	0
Alex Bapties	UT Martin	Oct. 29, 2016	Memphis	96	93	97	95	85	88	554	13	93	95	96	98	96	95	573	22
Brigitte Curcio	UT Martin	Oct. 29, 2016	Memphis	98	91	99	97	92	92	569	21	98	98	96	96	95	96	579	32
Andre Delcalzo	UT Martin	Oct. 29, 2016	Memphis	93	87	96	95	88	84	543	14	0	0	0	0	0	0	0	0
Logan Hunt	UT Martin	Oct. 29, 2016	Memphis	93	91	98	97	83	89	551	12	95	98	99	92	95	93	572	30
Kaitlin Korinek	UT Martin	Oct. 29, 2016	Memphis	96	94	94	97	93	92	566	18	99	99	96	98	98	98	588	36
Joe Martin	UT Martin	Oct. 29, 2016	Memphis	98	98	100	100	92	95	583	35	99	97	97	96	96	97	582	33
Alex Tamboli	UT Martin	Oct. 29, 2016	Memphis	96	94	96	98	90	93	567	0	94	91	95	95	95	94	564	22
Jack Berhorst	Memphis	Oct. 29, 2016	Memphis	95	98	99	100	91	95	578	26	97	97	98	93	96	96	577	22
Haylea Broughton	Memphis	Oct. 29, 2016	Memphis	94	95	98	99	88	95	569	24	96	92	98	96	96	98	576	29
Levi Clark	Memphis	Oct. 29, 2016	Memphis	96	94	99	100	95	96	580	30	98	97	100	100	93	98	586	41
Leighton Dempster	Memphis	Oct. 29, 2016	Memphis	92	94	100	97	92	93	568	22	99	98	96	97	96	98	584	37
Makennon Doran	Memphis	Oct. 29, 2016	Memphis	0	0	0	0	0	0	0	0	0	0	0	0	0	0	0	0
Amberlie Ezell	Memphis	Oct. 29, 2016	Memphis	97	97	96	99	87	91	567	22	95	96	94	96	96	97	574	25
Amy Fister	Memphis	Oct. 29, 2016	Memphis	97	97	98	98	94	93	577	29	96	96	100	97	99	98	586	35
Eli Rischling	Memphis	Oct. 29, 2016	Memphis	95	97	98	98	87	91	566	22	94	97	97	98	92	93	571	25
Abby Votava	Memphis	Oct. 29, 2016	Memphis	85	94	94	96	92	93	554	14	95	95	91	96	96	94	567	25
Erin Bell	UT Martin (W)	Oct. 29, 2016	Memphis	0	0	0	0	0	0	0	0	0	0	0	0	0	0	0	0
Ashley Coots	UT Martin (W)	Oct. 29, 2016	Memphis	96	90	99	98	92	92	567	24	96	94	94	96	98	98	576	28
Lindsey Flint	UT Martin (W)	Oct. 29, 2016	Memphis	97	98	94	94	91	93	567	21	92	97	95	94	92	90	560	24
Amanda Mayo	UT Martin (W)	Oct. 29, 2016	Memphis	0	0	0	0	0	0	0	0	91	93	96	93	93	94	560	21
Jennifer Plocinik	UT Martin (W)	Oct. 29, 2016	Memphis	92	94	97	96	90	89	558	13	96	94	99	96	96	99	580	29
Brianna Sawyers	UT Martin (W)	Oct. 29, 2016	Memphis	92	88	95	100	86	93	554	19	99	97	92	92	95	95	570	26
Alyson Sylvester	UT Martin (W)	Oct. 29, 2016	Memphis	95	96	96	95	91	94	567	15	93	96	92	95	99	98	573	27
Katie Brown	Nebraska	Oct. 29, 2016	Nebraska	95	91	95	98	85	84	548	0	95	93	93	96	95	94	566	0
Jaycee Carter	Nebraska	Oct. 29, 2016	Nebraska	97	92	97	97	90	93	566	0	99	97	98	95	98	97	584	36
Dacotah Faught	Nebraska	Oct. 29, 2016	Nebraska	93	92	100	99	90	93	567	23	99	98	99	99	99	100	594	48
Kayla Gadeken	Nebraska	Oct. 29, 2016	Nebraska	91	95	96	100	93	94	569	18	96	96	97	97	99	98	583	0
Maddie Korthas	Nebraska	Oct. 29, 2016	Nebraska	95	86	98	94	93	91	557	0	97	97	95	94	98	94	575	0
Rachel Martin	Nebraska	Oct. 29, 2016	Nebraska	98	93	97	99	97	96	580	30	96	99	99	98	99	98	589	41
Jordan Miller	Nebraska	Oct. 29, 2016	Nebraska	95	94	99	96	94	92	570	0	98	99	98	98	97	95	585	0
Samantha Peterson	Nebraska	Oct. 29, 2016	Nebraska	97	98	99	97	94	95	580	28	97	99	97	100	100	100	593	47
Nina Radulovic	Nebraska	Oct. 29, 2016	Nebraska	94	95	100	100	94	90	573	24	96	95	96	98	97	97	579	27
Sarah Sutton	Nebraska	Oct. 29, 2016	Nebraska	90	91	97	98	90	90	556	0	97	100	97	97	96	95	582	0
Hannah Virga	Nebraska	Oct. 29, 2016	Nebraska	96	96	98	99	93	90	572	0	96	96	100	97	97	92	578	0
Rachel Yager	Nebraska	Oct. 29, 2016	Nebraska	94	97	98	100	90	96	575	0	96	98	98	97	99	97	585	0
Deanna Binnie	Ohio State	Oct. 29, 2016	Nebraska	0	0	0	0	0	0	0	0	0	0	0	0	0	0	0	0
Josh Black	Ohio State	Oct. 29, 2016	Nebraska	90	95	99	99	90	94	567	24	94	95	97	98	99	97	580	33
Jacob Buchanan	Ohio State	Oct. 29, 2016	Nebraska	98	97	100	98	93	94	580	28	97	97	98	98	96	95	581	32
Drew Cheezum	Ohio State	Oct. 29, 2016	Nebraska	98	95	100	99	97	97	586	35	97	100	98	99	98	98	590	38
Anthony Cuozzo	Ohio State	Oct. 29, 2016	Nebraska	0	0	0	0	0	0	0	0	0	0	0	0	0	0	0	0
Kendal Elder	Ohio State	Oct. 29, 2016	Nebraska	0	0	0	0	0	0	0	0	0	0	0	0	0	0	0	0
Alli Kissell	Ohio State	Oct. 29, 2016	Nebraska	0	0	0	0	0	0	0	0	0	0	0	0	0	0	0	0
Mark Matheny	Ohio State	Oct. 29, 2016	Nebraska	90	91	99	98	95	94	567	24	96	97	98	99	100	100	590	44
Patrick Sardo	Ohio State	Oct. 29, 2016	Nebraska	0	0	0	0	0	0	0	0	0	0	0	0	0	0	0	0
Michael Steinel	Ohio State	Oct. 29, 2016	Nebraska	97	93	98	97	95	94	574	0	100	98	100	99	100	97	594	0
Chrissy Thomas	Ohio State	Oct. 29, 2016	Nebraska	0	0	0	0	0	0	0	0	0	0	0	0	0	0	0	0
Rhiann Travis	Ohio State	Oct. 29, 2016	Nebraska	95	94	99	99	96	94	577	27	97	98	99	100	98	99	591	42
Bailey Urbach	Ohio State	Oct. 29, 2016	Nebraska	0	0	0	0	0	0	0	0	0	0	0	0	0	0	0	0
Brendan Whitaker	Ohio State	Oct. 29, 2016	Nebraska	0	0	0	0	0	0	0	0	0	0	0	0	0	0	0	0
Quintin Wotring	Ohio State	Oct. 29, 2016	Nebraska	94	98	99	100	94	92	577	0	96	94	97	96	98	95	576	0
William Davidson	VMI	Oct. 29, 2016	VMI	92	86	95	97	95	83	548	0	92	96	94	96	96	95	569	0
Andrew Hickey	VMI	Oct. 29, 2016	VMI	91	85	100	98	92	89	555	0	94	93	96	95	93	96	567	0
Jacob Hunter	VMI	Oct. 29, 2016	VMI	96	89	97	95	86	85	548	0	95	91	94	93	96	96	565	0
Zachary Johnson	VMI	Oct. 29, 2016	VMI	86	94	98	95	89	88	550	0	0	0	0	0	0	0	0	0
Mathew Lusardi	VMI	Oct. 29, 2016	VMI	93	89	97	96	85	79	539	0	0	0	0	0	0	0	0	0
Chris Milliken	VMI	Oct. 29, 2016	VMI	93	81	97	99	83	83	536	0	97	92	96	93	93	97	568	0
John Pitman	VMI	Oct. 29, 2016	VMI	88	93	98	96	86	85	546	0	0	0	0	0	0	0	0	0
Nick Reynolds	VMI	Oct. 29, 2016	VMI	96	94	95	97	95	88	565	0	91	97	94	95	94	96	567	0
Rosemary Kramer	Ga. Southern	Oct. 29, 2016	VMI	90	90	92	95	90	87	544	0	96	97	99	97	95	100	584	0
Tori Lewis	Ga. Southern	Oct. 29, 2016	VMI	91	93	95	99	88	89	555	0	97	94	98	94	96	98	577	0
Jennifer Middlebrook	Ga. Southern	Oct. 29, 2016	VMI	0	0	0	0	0	0	0	0	0	0	0	0	0	0	0	0
Lydia Odlin	Ga. Southern	Oct. 29, 2016	VMI	86	90	93	98	87	79	533	0	98	95	93	96	95	96	573	0
Chastity Price	Ga. Southern	Oct. 29, 2016	VMI	85	82	90	96	82	85	520	0	89	95	90	91	92	95	552	0
Courtney Weekley	Ga. Southern	Oct. 29, 2016	VMI	96	92	97	95	89	92	561	0	98	94	95	95	96	98	576	0
Kathryn Youngblood	Ga. Southern	Oct. 29, 2016	VMI	0	0	0	0	0	0	0	0	0	0	0	0	0	0	0	0
Kelia Aardema	VMI (W)	Oct. 29, 2016	VMI	89	86	93	94	72	64	498	0	0	0	0	0	0	0	0	0
Samantha Alexander	VMI (W)	Oct. 29, 2016	VMI	91	87	94	95	91	88	546	0	94	92	96	93	95	95	565	0
Ellana Avery	VMI (W)	Oct. 29, 2016	VMI	93	88	96	90	82	76	525	0	0	0	0	0	0	0	0	0
Sabrina Bell	VMI (W)	Oct. 29, 2016	VMI	0	0	0	0	0	0	0	0	93	92	90	90	90	89	544	0
Alice Chiu	VMI (W)	Oct. 29, 2016	VMI	92	92	94	96	91	86	551	0	95	94	93	89	92	93	556	0
Jamie Foster	VMI (W)	Oct. 29, 2016	VMI	0	0	0	0	0	0	0	0	81	81	82	81	84	89	498	0
Joelle Henry	VMI (W)	Oct. 29, 2016	VMI	0	0	0	0	0	0	0	0	81	90	84	85	85	86	511	0
Rachel Jankelow	VMI (W)	Oct. 29, 2016	VMI	86	80	92	93	88	87	526	0	88	90	93	92	97	90	550	0
Kerrie Lightfoot	VMI (W)	Oct. 29, 2016	VMI	0	0	0	0	0	0	0	0	88	93	91	87	92	89	540	0
Loyce Lightfoot	VMI (W)	Oct. 29, 2016	VMI	92	90	95	95	84	92	548	0	0	0	0	0	0	0	0	0
Kaitlyn Morrison	VMI (W)	Oct. 29, 2016	VMI	0	0	0	0	0	0	0	0	0	0	0	0	0	0	0	0
Katherine Watson	VMI (W)	Oct. 29, 2016	VMI	88	79	95	96	82	86	526	0	92	95	96	94	95	95	567	0
Lauryn Cinadr	Akron	Oct. 29, 2016	USciences	85	96	93	94	86	91	545	0	95	99	96	97	95	91	573	0
Alex Fedorko	Akron	Oct. 29, 2016	USciences	0	0	0	0	0	0	0	0	0	0	0	0	0	0	0	0
Sydney Goldschlag	Akron	Oct. 29, 2016	USciences	92	93	95	97	88	88	553	0	97	98	95	95	95	95	575	0
Rebecca Green	Akron	Oct. 29, 2016	USciences	89	89	88	95	85	92	538	0	92	93	94	94	94	93	560	0
Julia Hatch	Akron	Oct. 29, 2016	USciences	99	97	96	99	91	91	573	0	96	98	99	96	97	97	583	0
Anthony Jackson	Akron	Oct. 29, 2016	USciences	92	93	99	98	91	90	563	0	95	95	97	98	97	98	580	0
Kera Kaufman	Akron	Oct. 29, 2016	USciences	88	88	95	95	82	87	535	0	94	94	94	94	96	98	570	0
Joshua Kovach	Akron	Oct. 29, 2016	USciences	0	0	0	0	0	0	0	0	0	0	0	0	0	0	0	0
Caleb Lloyd	Akron	Oct. 29, 2016	USciences	95	99	100	96	96	91	577	0	92	99	98	98	93	97	577	0
Danielle Makucevich	Akron	Oct. 29, 2016	USciences	0	0	0	0	0	0	0	0	0	0	0	0	0	0	0	0
Kris Mantel	Akron	Oct. 29, 2016	USciences	0	0	0	0	0	0	0	0	0	0	0	0	0	0	0	0
Brent Morgan	Akron	Oct. 29, 2016	USciences	0	0	0	0	0	0	0	0	0	0	0	0	0	0	0	0
Connor O'Mara	Akron	Oct. 29, 2016	USciences	90	93	98	95	88	93	557	0	97	95	98	95	92	99	576	0
Marlee Reynolds	Akron	Oct. 29, 2016	USciences	0	0	0	0	0	0	0	0	0	0	0	0	0	0	0	0
Sean Roehrs	Akron	Oct. 29, 2016	USciences	0	0	0	0	0	0	0	0	0	0	0	0	0	0	0	0
Zach Strohl	Akron	Oct. 29, 2016	USciences	95	94	99	99	85	94	566	0	100	99	98	99	96	98	590	0
Cierra Terrizzi	Akron	Oct. 29, 2016	USciences	92	96	99	97	90	86	560	0	98	99	94	100	99	98	588	0
Rachel Hubal	USciences	Oct. 29, 2016	USciences	0	0	0	0	0	0	0	0	93	85	90	88	84	89	529	0
Angela Kang	USciences	Oct. 29, 2016	USciences	83	75	88	89	79	82	496	0	94	88	90	89	89	87	537	0
Brittany Mahoney	USciences	Oct. 29, 2016	USciences	0	0	0	0	0	0	0	0	0	0	0	0	0	0	0	0
Chris Makosiej	USciences	Oct. 29, 2016	USciences	0	0	0	0	0	0	0	0	0	0	0	0	0	0	0	0
Nick Makosiej	USciences	Oct. 29, 2016	USciences	0	0	0	0	0	0	0	0	0	0	0	0	0	0	0	0
Thomas Nelligan	USciences	Oct. 29, 2016	USciences	0	0	0	0	0	0	0	0	0	0	0	0	0	0	0	0
Matt Popowicz	USciences	Oct. 29, 2016	USciences	86	92	93	93	80	77	521	0	88	81	88	83	85	83	508	0
Andrej Quatrone	USciences	Oct. 29, 2016	USciences	0	0	0	0	0	0	0	0	92	85	84	89	90	87	527	0
Sarah Schnupp	USciences	Oct. 29, 2016	USciences	95	97	98	98	91	94	573	0	96	95	95	94	100	93	573	0
Lauren Stabler	USciences	Oct. 29, 2016	USciences	0	0	0	0	0	0	0	0	88	86	84	85	88	85	516	0
Christina Tipton	USciences	Oct. 29, 2016	USciences	0	0	0	0	0	0	0	0	0	0	0	0	0	0	0	0
Allie Tuman	USciences	Oct. 29, 2016	USciences	85	85	88	90	79	75	502	0	85	84	86	85	90	92	522	0
Anita Varkey	USciences	Oct. 29, 2016	USciences	0	0	0	0	0	0	0	0	80	72	76	81	76	85	470	0
Andrew Visconti	USciences	Oct. 29, 2016	USciences	94	95	98	99	79	89	554	0	90	94	90	90	93	93	550	0
Nick Zsoldos	USciences	Oct. 29, 2016	USciences	88	95	94	92	84	91	544	0	87	85	92	90	87	86	527	0
Hayley Carroll	Ole Miss	Oct. 29, 2016	Jacksonville St.	95	93	100	100	90	94	572	0	97	98	98	99	98	95	585	0
Harley Gardner	Ole Miss	Oct. 29, 2016	Jacksonville St.	97	95	99	100	97	98	586	0	97	98	97	95	97	96	580	0
Jess Haig	Ole Miss	Oct. 29, 2016	Jacksonville St.	96	97	98	100	90	94	575	0	97	97	97	95	97	98	581	0
Alana Kelly	Ole Miss	Oct. 29, 2016	Jacksonville St.	96	90	99	99	91	92	567	0	99	96	96	98	96	96	581	0
Randi Loudin	Ole Miss	Oct. 29, 2016	Jacksonville St.	92	96	99	97	92	89	565	0	96	97	97	90	96	97	573	0
Marina Noble	Ole Miss	Oct. 29, 2016	Jacksonville St.	92	94	98	99	91	89	563	0	0	0	0	0	0	0	0	0
Samantha Sandifer	Ole Miss	Oct. 29, 2016	Jacksonville St.	94	94	95	99	89	88	559	0	92	97	98	95	98	98	578	0
Kristyn Trump	Ole Miss	Oct. 29, 2016	Jacksonville St.	96	92	99	97	89	95	568	0	97	94	98	96	95	94	574	0
Jillian Tyler	Ole Miss	Oct. 29, 2016	Jacksonville St.	89	90	100	100	93	90	562	0	99	98	98	100	97	98	590	0
Ali Weisz	Ole Miss	Oct. 29, 2016	Jacksonville St.	97	97	99	99	97	96	585	0	99	99	100	100	97	100	595	0
Hunter Behrends	Jacksonville St.	Oct. 29, 2016	Jacksonville St.	94	85	98	100	90	90	557	0	96	96	95	97	94	94	572	0
Austin Cock	Jacksonville St.	Oct. 29, 2016	Jacksonville St.	96	98	96	98	96	91	575	0	98	99	94	95	95	97	578	0
Anika Corsi	Jacksonville St.	Oct. 29, 2016	Jacksonville St.	0	0	0	0	0	0	0	0	98	96	97	94	98	96	579	0
Trace Haynes	Jacksonville St.	Oct. 29, 2016	Jacksonville St.	98	100	99	100	96	95	588	0	97	97	94	99	97	96	580	0
Brandon Henson	Jacksonville St.	Oct. 29, 2016	Jacksonville St.	0	0	0	0	0	0	0	0	96	92	94	98	96	97	573	0
Brandon Muske	Jacksonville St.	Oct. 29, 2016	Jacksonville St.	95	98	95	96	94	94	572	0	98	100	98	99	98	100	593	0
Kyle Ordille	Jacksonville St.	Oct. 29, 2016	Jacksonville St.	90	92	99	95	86	93	555	0	96	95	95	97	97	94	574	0
Carleigh Peters	Jacksonville St.	Oct. 29, 2016	Jacksonville St.	94	90	95	99	89	87	554	0	95	97	99	98	97	98	584	0
Garrett Rabel	Jacksonville St.	Oct. 29, 2016	Jacksonville St.	99	96	100	98	96	90	579	0	95	94	98	97	96	98	578	0
Tyler Ramos	Jacksonville St.	Oct. 29, 2016	Jacksonville St.	97	95	99	97	90	86	564	0	97	94	96	96	95	98	576	0
Mekenna Richardson	Jacksonville St.	Oct. 29, 2016	Jacksonville St.	97	95	97	100	96	96	581	0	96	96	95	94	98	94	573	0
Carter Santrock	Jacksonville St.	Oct. 29, 2016	Jacksonville St.	92	95	97	97	96	95	572	0	96	94	96	96	97	99	578	0
Zach Schmidt	Jacksonville St.	Oct. 29, 2016	Jacksonville St.	94	95	96	99	94	97	575	0	97	96	96	98	95	97	579	0
David Sink	Jacksonville St.	Oct. 29, 2016	Jacksonville St.	95	94	99	98	91	97	574	0	98	97	98	94	99	98	584	0
Bobby Broadstreet	Murray St.	Oct. 30, 2016	Murray St.	99	98	99	99	97	98	590	0	99	98	97	100	97	99	590	0
Meike Drewell	Murray St.	Oct. 30, 2016	Murray St.	95	99	98	100	99	96	587	0	98	97	98	99	100	100	592	0
Ben Estes	Murray St.	Oct. 30, 2016	Murray St.	97	98	100	100	95	96	586	0	97	97	98	99	99	99	589	0
Shelby Huber	Murray St.	Oct. 30, 2016	Murray St.	95	99	99	99	94	92	578	0	99	97	98	96	98	97	585	0
Mackenzie Martin	Murray St.	Oct. 30, 2016	Murray St.	99	96	100	100	94	95	584	0	99	98	98	99	98	100	592	0
Ivan Roe	Murray St.	Oct. 30, 2016	Murray St.	98	100	100	99	97	98	592	0	100	100	98	100	99	97	594	0
Barbara Schlapfer	Murray St.	Oct. 30, 2016	Murray St.	98	98	98	100	97	94	585	0	99	97	96	97	96	97	582	0
Alathea Sellars	Murray St.	Oct. 30, 2016	Murray St.	91	96	99	98	96	95	575	0	100	99	98	98	98	99	592	0
Eric Sloan	Murray St.	Oct. 30, 2016	Murray St.	92	94	97	99	91	90	563	0	97	94	97	94	96	96	574	0
Alex Bapties	UT Martin	Oct. 30, 2016	Murray St.	95	95	98	98	85	83	554	0	98	96	99	98	95	97	583	0
Brigitte Curcio	UT Martin	Oct. 30, 2016	Murray St.	95	95	94	95	93	95	567	0	94	97	95	97	97	96	576	0
Andre Delcalzo	UT Martin	Oct. 30, 2016	Murray St.	92	90	97	95	80	83	537	0	95	94	94	92	93	96	564	0
Logan Hunt	UT Martin	Oct. 30, 2016	Murray St.	95	93	99	98	87	87	559	0	95	94	95	94	98	94	570	0
Kaitlin Korinek	UT Martin	Oct. 30, 2016	Murray St.	94	96	98	97	95	98	578	0	96	96	97	97	96	99	581	0
Joe Martin	UT Martin	Oct. 30, 2016	Murray St.	95	96	100	100	94	94	579	0	96	97	96	98	96	98	581	0
Alex Tamboli	UT Martin	Oct. 30, 2016	Murray St.	96	93	95	97	90	89	560	0	96	97	91	95	93	93	565	0
Erin Bell	UT Martin (W)	Oct. 30, 2016	Murray St.	0	0	0	0	0	0	0	0	0	0	0	0	0	0	0	0
Ashley Coots	UT Martin (W)	Oct. 30, 2016	Murray St.	91	98	99	99	95	88	570	0	97	95	93	96	95	96	572	0
Lindsey Flint	UT Martin (W)	Oct. 30, 2016	Murray St.	97	94	99	97	83	89	559	0	93	89	90	97	97	94	560	0
Amanda Mayo	UT Martin (W)	Oct. 30, 2016	Murray St.	86	95	98	97	78	83	537	0	95	90	92	90	89	93	549	0
Jennifer Plocinik	UT Martin (W)	Oct. 30, 2016	Murray St.	95	99	99	98	91	95	577	0	95	93	94	99	96	97	574	0
Brianna Sawyers	UT Martin (W)	Oct. 30, 2016	Murray St.	98	93	96	99	93	89	568	0	99	98	97	99	96	97	586	0
Alyson Sylvester	UT Martin (W)	Oct. 30, 2016	Murray St.	97	93	92	94	90	91	557	0	92	95	93	96	93	93	562	0
Nathan Brewer	Army	Oct. 30, 2016	Morehead St.	93	96	97	98	95	92	571	0	97	99	96	96	96	97	581	0
Emiliano Concha-Toro	Army	Oct. 30, 2016	Morehead St.	0	0	0	0	0	0	0	0	0	0	0	0	0	0	0	0
Ethan Cook	Army	Oct. 30, 2016	Morehead St.	0	0	0	0	0	0	0	0	0	0	0	0	0	0	0	0
Danielle Cuomo	Army	Oct. 30, 2016	Morehead St.	97	98	100	99	92	94	580	0	98	98	100	97	100	98	591	0
Maggie Ehmann	Army	Oct. 30, 2016	Morehead St.	0	0	0	0	0	0	0	0	0	0	0	0	0	0	0	0
Maddy Erikson	Army	Oct. 30, 2016	Morehead St.	93	92	95	97	92	95	564	0	96	98	95	99	99	98	585	0
Mike Garner	Army	Oct. 30, 2016	Morehead St.	94	96	97	98	84	88	557	0	94	98	96	99	98	95	580	0
Nick Kanellis	Army	Oct. 30, 2016	Morehead St.	0	0	0	0	0	0	0	0	0	0	0	0	0	0	0	0
Marvin Lewis	Army	Oct. 30, 2016	Morehead St.	93	94	96	100	87	94	564	0	98	100	100	100	96	99	593	0
Rhianna Lichtenthal	Army	Oct. 30, 2016	Morehead St.	0	0	0	0	0	0	0	0	0	0	0	0	0	0	0	0
Libby Mostert	Army	Oct. 30, 2016	Morehead St.	0	0	0	0	0	0	0	0	0	0	0	0	0	0	0	0
Sarah Nakata	Army	Oct. 30, 2016	Morehead St.	0	0	0	0	0	0	0	0	0	0	0	0	0	0	0	0
Payne Nunn	Army	Oct. 30, 2016	Morehead St.	95	94	98	97	95	95	574	0	96	98	98	98	98	94	582	0
Allen Solida	Army	Oct. 30, 2016	Morehead St.	0	0	0	0	0	0	0	0	0	0	0	0	0	0	0	0
Andrew Solomonides	Army	Oct. 30, 2016	Morehead St.	0	0	0	0	0	0	0	0	0	0	0	0	0	0	0	0
Seth Baker	Morehead St.	Oct. 30, 2016	Morehead St.	98	96	99	97	91	90	571	0	95	95	97	97	95	96	575	0
Brandon Bryer	Morehead St.	Oct. 30, 2016	Morehead St.	96	93	96	99	87	91	562	0	94	94	95	96	97	97	573	0
Siarra Crum	Morehead St.	Oct. 30, 2016	Morehead St.	89	91	92	99	92	90	553	0	96	98	98	96	96	99	583	0
Sarah Fink	Morehead St.	Oct. 30, 2016	Morehead St.	94	92	98	99	91	95	569	0	98	100	94	95	96	94	577	0
Joe Fischer	Morehead St.	Oct. 30, 2016	Morehead St.	96	99	100	96	91	89	571	0	95	98	99	97	99	95	583	0
Dan Hall	Morehead St.	Oct. 30, 2016	Morehead St.	97	98	99	98	91	85	568	0	93	95	97	93	96	99	573	0
Jesse Moyer	Morehead St.	Oct. 30, 2016	Morehead St.	94	95	97	95	91	93	565	0	96	95	94	98	100	99	582	0
Alexa Potts	Morehead St.	Oct. 30, 2016	Morehead St.	93	98	96	98	93	92	570	0	94	94	95	99	99	95	576	0
Karly Potts	Morehead St.	Oct. 30, 2016	Morehead St.	95	94	96	97	89	84	555	0	97	96	98	99	98	99	587	0
Melanie West	Morehead St.	Oct. 30, 2016	Morehead St.	92	97	95	99	91	86	560	0	94	96	96	96	99	95	576	0
Haley Wilson	Morehead St.	Oct. 30, 2016	Morehead St.	91	96	97	99	97	91	571	0	99	95	97	97	98	97	583	0
Soren Butler	Alaska Fairbanks	Nov. 4, 2016	UTEP	96	98	99	100	92	93	578	0	99	98	98	98	98	96	587	0
Liam Eberhart	Alaska Fairbanks	Nov. 4, 2016	UTEP	0	0	0	0	0	0	0	0	0	0	0	0	0	0	0	0
Amy Gentry	Alaska Fairbanks	Nov. 4, 2016	UTEP	92	93	98	94	95	88	560	0	99	98	99	98	95	98	587	0
Luke Johnson	Alaska Fairbanks	Nov. 4, 2016	UTEP	100	97	98	100	94	91	580	0	93	96	95	97	99	97	577	0
Sagen Maddalena	Alaska Fairbanks	Nov. 4, 2016	UTEP	99	95	99	97	95	95	580	0	99	97	99	100	100	100	595	0
Grace Nelson	Alaska Fairbanks	Nov. 4, 2016	UTEP	0	0	0	0	0	0	0	0	0	0	0	0	0	0	0	0
JT Schnering	Alaska Fairbanks	Nov. 4, 2016	UTEP	93	93	100	100	91	91	568	0	97	97	99	99	98	97	587	0
Robert Scott	Alaska Fairbanks	Nov. 4, 2016	UTEP	91	92	99	97	95	93	567	0	96	98	98	96	95	96	579	0
Nathan Taylor	Alaska Fairbanks	Nov. 4, 2016	UTEP	0	0	0	0	0	0	0	0	0	0	0	0	0	0	0	0
Jessica Kinder	UTEP	Nov. 4, 2016	UTEP	0	0	0	0	0	0	0	0	96	97	97	99	99	97	585	0
Abby Monique	UTEP	Nov. 4, 2016	UTEP	90	96	97	98	90	91	562	0	97	95	96	95	96	92	571	0
Maranda Nelson	UTEP	Nov. 4, 2016	UTEP	93	93	96	96	92	92	562	0	94	99	97	95	96	96	577	0
Bailey Powell	UTEP	Nov. 4, 2016	UTEP	94	95	97	98	94	92	570	0	98	97	99	98	99	99	590	0
Mara Rouse	UTEP	Nov. 4, 2016	UTEP	0	0	0	0	0	0	0	0	94	96	96	95	96	96	573	0
Rachael Schoenrock	UTEP	Nov. 4, 2016	UTEP	95	97	98	96	95	93	574	0	93	96	99	98	96	99	581	0
Haylee Schoenrock	UTEP	Nov. 4, 2016	UTEP	93	94	94	97	95	92	565	0	96	100	98	99	97	96	586	0
Monthserrat Serna	UTEP	Nov. 4, 2016	UTEP	0	0	0	0	0	0	0	0	89	95	95	97	94	91	561	0
Lauryn Cinadr	Akron	Nov. 4, 2016	Kentucky	0	0	0	0	0	0	0	0	0	0	0	0	0	0	0	0
Alex Fedorko	Akron	Nov. 4, 2016	Kentucky	90	90	99	98	92	79	548	0	96	91	90	94	97	96	564	0
Sydney Goldschlag	Akron	Nov. 4, 2016	Kentucky	91	95	97	96	88	87	554	0	95	95	97	98	96	94	575	0
Rebecca Green	Akron	Nov. 4, 2016	Kentucky	0	0	0	0	0	0	0	0	0	0	0	0	0	0	0	0
Julia Hatch	Akron	Nov. 4, 2016	Kentucky	95	95	99	97	92	87	565	0	92	93	97	95	94	97	568	0
Anthony Jackson	Akron	Nov. 4, 2016	Kentucky	89	95	100	98	89	95	566	0	95	97	98	95	94	94	573	0
Kera Kaufman	Akron	Nov. 4, 2016	Kentucky	0	0	0	0	0	0	0	0	0	0	0	0	0	0	0	0
Joshua Kovach	Akron	Nov. 4, 2016	Kentucky	94	95	97	98	90	94	568	0	97	93	94	96	91	96	567	0
Caleb Lloyd	Akron	Nov. 4, 2016	Kentucky	97	95	99	100	93	87	571	0	95	94	97	98	99	95	578	0
Danielle Makucevich	Akron	Nov. 4, 2016	Kentucky	0	0	0	0	0	0	0	0	0	0	0	0	0	0	0	0
Kris Mantel	Akron	Nov. 4, 2016	Kentucky	0	0	0	0	0	0	0	0	0	0	0	0	0	0	0	0
Brent Morgan	Akron	Nov. 4, 2016	Kentucky	0	0	0	0	0	0	0	0	0	0	0	0	0	0	0	0
Connor O'Mara	Akron	Nov. 4, 2016	Kentucky	88	95	98	100	92	93	566	0	96	99	99	97	98	98	587	0
Marlee Reynolds	Akron	Nov. 4, 2016	Kentucky	0	0	0	0	0	0	0	0	0	0	0	0	0	0	0	0
Sean Roehrs	Akron	Nov. 4, 2016	Kentucky	95	95	95	95	90	86	556	0	97	94	98	93	94	97	573	0
Zach Strohl	Akron	Nov. 4, 2016	Kentucky	97	97	99	97	94	95	579	0	99	98	98	99	99	96	589	0
Cierra Terrizzi	Akron	Nov. 4, 2016	Kentucky	93	94	100	100	95	85	567	0	97	100	97	98	98	97	587	0
Billy Azzinaro	Kentucky	Nov. 4, 2016	Kentucky	96	97	100	99	96	95	583	0	96	99	98	98	98	97	586	0
Jenna Bethea	Kentucky	Nov. 4, 2016	Kentucky	92	93	96	99	94	92	566	0	97	97	98	98	98	99	587	0
Hanna Carr	Kentucky	Nov. 4, 2016	Kentucky	99	97	98	99	96	99	588	0	98	98	100	98	99	99	592	0
Morgan Duerr	Kentucky	Nov. 4, 2016	Kentucky	97	95	99	97	85	89	562	0	96	96	97	97	97	98	581	0
Ian Foos	Kentucky	Nov. 4, 2016	Kentucky	96	90	96	96	94	95	567	0	96	97	98	95	96	98	580	0
Carmen Fry	Kentucky	Nov. 4, 2016	Kentucky	95	97	99	99	97	95	582	0	99	98	98	100	96	99	590	0
Heather Kirby	Kentucky	Nov. 4, 2016	Kentucky	98	97	99	99	97	95	585	0	100	100	100	100	98	98	596	0
Sonya May	Kentucky	Nov. 4, 2016	Kentucky	98	96	100	100	97	98	589	0	98	97	95	96	95	97	578	0
Andrew Miller	Kentucky	Nov. 4, 2016	Kentucky	95	90	99	98	87	91	560	0	96	93	97	98	96	95	575	0
Cathryn Papasodora	Kentucky	Nov. 4, 2016	Kentucky	96	97	94	98	91	94	570	0	99	100	96	100	98	98	591	0
Jason Scharbel	Kentucky	Nov. 4, 2016	Kentucky	96	95	100	99	94	95	579	0	94	99	98	98	97	99	585	0
Jason Spaude	Kentucky	Nov. 4, 2016	Kentucky	99	98	97	96	97	94	581	0	96	96	99	100	99	97	587	0
Seth Baker	Morehead St.	Nov. 5, 2016	Morehead St.	96	96	97	100	94	88	571	0	95	92	96	97	95	98	573	0
Brandon Bryer	Morehead St.	Nov. 5, 2016	Morehead St.	95	96	95	99	91	93	569	0	94	98	99	98	97	98	584	0
Siarra Crum	Morehead St.	Nov. 5, 2016	Morehead St.	86	91	94	98	86	91	546	0	95	96	96	96	93	95	571	0
Sarah Fink	Morehead St.	Nov. 5, 2016	Morehead St.	95	92	96	96	90	89	558	0	94	95	98	96	96	93	572	0
Joe Fischer	Morehead St.	Nov. 5, 2016	Morehead St.	93	98	99	99	92	87	568	0	99	96	97	95	97	97	581	0
Dan Hall	Morehead St.	Nov. 5, 2016	Morehead St.	96	99	98	100	95	96	584	0	93	96	97	97	97	97	577	0
Jesse Moyer	Morehead St.	Nov. 5, 2016	Morehead St.	0	0	0	0	0	0	0	0	0	0	0	0	0	0	0	0
Alexa Potts	Morehead St.	Nov. 5, 2016	Morehead St.	96	99	96	95	91	95	572	0	96	98	95	96	95	98	578	0
Karly Potts	Morehead St.	Nov. 5, 2016	Morehead St.	96	91	97	92	92	95	563	0	98	96	96	96	97	97	580	0
Melanie West	Morehead St.	Nov. 5, 2016	Morehead St.	88	93	96	99	88	87	551	0	95	97	97	87	90	90	556	0
Haley Wilson	Morehead St.	Nov. 5, 2016	Morehead St.	87	96	98	97	93	89	560	0	97	97	96	95	98	98	581	0
Bobby Broadstreet	Murray St.	Nov. 5, 2016	Morehead St.	94	97	98	97	92	93	571	0	100	100	99	99	98	96	592	0
Meike Drewell	Murray St.	Nov. 5, 2016	Morehead St.	97	93	98	97	97	95	577	0	96	98	97	100	99	96	586	0
Ben Estes	Murray St.	Nov. 5, 2016	Morehead St.	96	96	99	97	98	95	581	0	97	100	96	99	98	99	589	0
Shelby Huber	Murray St.	Nov. 5, 2016	Morehead St.	0	0	0	0	0	0	0	0	0	0	0	0	0	0	0	0
Mackenzie Martin	Murray St.	Nov. 5, 2016	Morehead St.	93	96	99	100	96	96	580	0	98	99	99	100	99	99	594	0
Ivan Roe	Murray St.	Nov. 5, 2016	Morehead St.	100	96	100	99	96	97	588	0	100	98	99	100	99	99	595	0
Barbara Schlapfer	Murray St.	Nov. 5, 2016	Morehead St.	99	99	96	96	88	95	573	0	97	97	95	98	97	100	584	0
Alathea Sellars	Murray St.	Nov. 5, 2016	Morehead St.	95	98	98	97	97	94	579	0	100	98	100	99	100	100	597	0
Eric Sloan	Murray St.	Nov. 5, 2016	Morehead St.	0	0	0	0	0	0	0	0	0	0	0	0	0	0	0	0
Allison Auten	Citadel	Nov. 5, 2016	Citadel	92	90	95	96	92	90	555	0	95	97	99	98	98	96	583	0
Matthew Davenport	Citadel	Nov. 5, 2016	Citadel	0	0	0	0	0	0	0	0	93	96	95	87	96	96	563	0
Joseph Ferguson	Citadel	Nov. 5, 2016	Citadel	0	0	0	0	0	0	0	0	91	94	90	93	90	93	551	0
Morgan Long	Citadel	Nov. 5, 2016	Citadel	92	86	93	99	82	89	541	0	97	98	96	93	93	97	574	0
Alexander McAlear	Citadel	Nov. 5, 2016	Citadel	90	89	95	96	88	83	541	0	95	96	96	95	97	95	574	0
Patrick Meyer	Citadel	Nov. 5, 2016	Citadel	0	0	0	0	0	0	0	0	92	97	92	90	96	90	557	0
Richie Parra	Citadel	Nov. 5, 2016	Citadel	91	93	93	92	91	88	548	0	98	96	95	93	97	97	576	0
Colton Poole	Citadel	Nov. 5, 2016	Citadel	96	93	95	99	93	90	566	0	96	96	97	95	97	94	575	0
Tommy Simrill	Citadel	Nov. 5, 2016	Citadel	0	0	0	0	0	0	0	0	95	93	92	89	92	92	553	0
Kealie Engels	Wofford	Nov. 5, 2016	Citadel	0	0	0	0	0	0	0	0	0	0	0	0	0	0	0	0
Seth Flanagan	Wofford	Nov. 5, 2016	Citadel	93	86	86	86	83	85	519	0	93	90	89	95	92	93	552	0
Cierra Holcombe	Wofford	Nov. 5, 2016	Citadel	96	94	95	97	87	94	563	0	95	96	92	91	95	94	563	0
Carson Howell	Wofford	Nov. 5, 2016	Citadel	0	0	0	0	0	0	0	0	0	0	0	0	0	0	0	0
Nicholas Hunter	Wofford	Nov. 5, 2016	Citadel	81	73	89	93	84	80	500	0	89	94	93	92	92	96	556	0
Zachry Hunter	Wofford	Nov. 5, 2016	Citadel	0	0	0	0	0	0	0	0	84	83	82	81	84	75	489	0
Reid Schuster	Wofford	Nov. 5, 2016	Citadel	83	88	88	91	70	75	495	0	83	86	87	85	85	84	510	0
Carli Cline	Citadel (W)	Nov. 5, 2016	Citadel	0	0	0	0	0	0	0	0	89	90	92	92	93	94	550	0
Brandi Duzz	Citadel (W)	Nov. 5, 2016	Citadel	90	90	97	82	62	34	455	0	93	90	89	91	93	92	548	0
Leah Fenwrick-Wallace	Citadel (W)	Nov. 5, 2016	Citadel	79	78	94	93	79	83	506	0	93	92	93	91	90	93	552	0
Shadonna Littlejohn	Citadel (W)	Nov. 5, 2016	Citadel	87	86	91	91	76	69	500	0	92	88	90	93	94	91	548	0
Tierra Price	Citadel (W)	Nov. 5, 2016	Citadel	0	0	0	0	0	0	0	0	77	81	86	94	84	84	506	0
Faith Totherow	Citadel (W)	Nov. 5, 2016	Citadel	96	91	99	93	89	83	551	0	96	89	89	87	88	95	544	0
Raven Wills	Citadel (W)	Nov. 5, 2016	Citadel	91	80	93	94	76	69	503	0	90	91	92	93	85	95	546	0
Alex Bapties	UT Martin	Nov. 5, 2016	Jacksonville St.	90	96	97	97	87	85	552	0	93	95	93	95	96	94	566	0
Brigitte Curcio	UT Martin	Nov. 5, 2016	Jacksonville St.	92	90	98	98	93	93	564	0	97	96	95	98	97	97	580	0
Andre Delcalzo	UT Martin	Nov. 5, 2016	Jacksonville St.	89	92	96	99	88	89	553	0	0	0	0	0	0	0	0	0
Logan Hunt	UT Martin	Nov. 5, 2016	Jacksonville St.	0	0	0	0	0	0	0	0	97	95	95	91	96	97	571	0
Kaitlin Korinek	UT Martin	Nov. 5, 2016	Jacksonville St.	95	91	99	99	95	98	577	0	98	99	94	98	98	96	583	0
Joe Martin	UT Martin	Nov. 5, 2016	Jacksonville St.	97	97	100	100	90	96	580	0	98	96	99	98	97	96	584	0
Alex Tamboli	UT Martin	Nov. 5, 2016	Jacksonville St.	94	94	97	98	94	85	562	0	93	96	94	94	90	96	563	0
Hunter Behrends	Jacksonville St.	Nov. 5, 2016	Jacksonville St.	93	94	98	97	91	88	561	0	95	93	94	99	97	97	575	0
Austin Cock	Jacksonville St.	Nov. 5, 2016	Jacksonville St.	96	95	98	95	84	92	560	0	97	98	99	98	97	96	585	0
Anika Corsi	Jacksonville St.	Nov. 5, 2016	Jacksonville St.	89	91	95	91	88	84	538	0	96	93	97	98	94	96	574	0
Trace Haynes	Jacksonville St.	Nov. 5, 2016	Jacksonville St.	93	95	98	99	93	91	569	0	94	95	97	98	95	95	574	0
Brandon Henson	Jacksonville St.	Nov. 5, 2016	Jacksonville St.	92	89	92	95	88	88	544	0	97	94	95	97	93	99	575	0
Brandon Muske	Jacksonville St.	Nov. 5, 2016	Jacksonville St.	97	94	95	95	95	91	567	0	98	97	97	97	99	98	586	0
Kyle Ordille	Jacksonville St.	Nov. 5, 2016	Jacksonville St.	94	94	97	99	97	90	571	0	98	95	95	97	95	99	579	0
Carleigh Peters	Jacksonville St.	Nov. 5, 2016	Jacksonville St.	92	95	98	97	91	92	565	0	97	96	97	96	99	97	582	0
Garrett Rabel	Jacksonville St.	Nov. 5, 2016	Jacksonville St.	98	97	100	99	85	90	569	0	97	93	95	96	95	95	571	0
Tyler Ramos	Jacksonville St.	Nov. 5, 2016	Jacksonville St.	98	97	97	99	90	90	571	0	95	99	93	98	96	95	576	0
Mekenna Richardson	Jacksonville St.	Nov. 5, 2016	Jacksonville St.	97	96	96	99	91	94	573	0	98	97	97	98	95	99	584	0
Carter Santrock	Jacksonville St.	Nov. 5, 2016	Jacksonville St.	94	96	96	94	92	95	567	0	97	99	97	97	98	96	584	0
Zach Schmidt	Jacksonville St.	Nov. 5, 2016	Jacksonville St.	94	96	99	98	95	95	577	0	98	97	95	94	94	95	573	0
David Sink	Jacksonville St.	Nov. 5, 2016	Jacksonville St.	91	94	100	98	95	92	570	0	99	97	97	96	96	95	580	0
Erin Bell	UT Martin (W)	Nov. 5, 2016	Jacksonville St.	0	0	0	0	0	0	0	0	0	0	0	0	0	0	0	0
Ashley Coots	UT Martin (W)	Nov. 5, 2016	Jacksonville St.	92	95	97	98	83	94	559	0	91	94	86	94	92	94	551	0
Lindsey Flint	UT Martin (W)	Nov. 5, 2016	Jacksonville St.	90	84	97	99	89	85	544	0	0	0	0	0	0	0	0	0
Amanda Mayo	UT Martin (W)	Nov. 5, 2016	Jacksonville St.	0	0	0	0	0	0	0	0	95	90	95	96	93	95	564	0
Jennifer Plocinik	UT Martin (W)	Nov. 5, 2016	Jacksonville St.	95	97	97	98	89	87	563	0	93	96	94	94	92	97	566	0
Brianna Sawyers	UT Martin (W)	Nov. 5, 2016	Jacksonville St.	90	93	98	95	88	88	552	0	93	97	92	98	92	91	563	0
Alyson Sylvester	UT Martin (W)	Nov. 5, 2016	Jacksonville St.	95	93	94	94	93	90	559	0	92	96	96	93	95	95	567	0
Jack Anderson	West Virginia	Nov. 5, 2016	West Virginia	92	94	97	99	96	92	570	0	97	99	97	100	98	97	588	0
Will Anti	West Virginia	Nov. 5, 2016	West Virginia	97	95	98	99	97	97	583	0	96	96	98	97	98	99	584	0
Milica Babic	West Virginia	Nov. 5, 2016	West Virginia	97	97	98	99	95	92	578	0	99	99	96	100	99	99	592	0
Noah Barker	West Virginia	Nov. 5, 2016	West Virginia	0	0	0	0	0	0	0	0	0	0	0	0	0	0	0	0
Elizabeth Gratz	West Virginia	Nov. 5, 2016	West Virginia	98	97	100	100	98	97	590	0	100	99	100	98	97	97	591	0
Jean-Pierre Lucas	West Virginia	Nov. 5, 2016	West Virginia	98	97	100	100	96	93	584	0	98	98	99	99	96	99	589	0
Morgan Phillips	West Virginia	Nov. 5, 2016	West Virginia	97	97	100	98	98	98	588	0	97	97	99	97	97	98	585	0
Ginny Thrasher	West Virginia	Nov. 5, 2016	West Virginia	98	98	100	98	96	99	589	0	96	99	98	100	99	98	590	0
Jack Berhorst	Memphis	Nov. 5, 2016	West Virginia	97	98	99	97	96	88	575	0	96	99	96	97	98	97	583	0
Haylea Broughton	Memphis	Nov. 5, 2016	West Virginia	93	96	100	100	91	89	569	0	99	96	98	97	99	98	587	0
Levi Clark	Memphis	Nov. 5, 2016	West Virginia	99	97	97	100	97	94	584	0	99	97	98	97	99	97	587	0
Leighton Dempster	Memphis	Nov. 5, 2016	West Virginia	96	89	95	92	94	94	560	0	94	99	97	95	98	98	581	0
Makennon Doran	Memphis	Nov. 5, 2016	West Virginia	0	0	0	0	0	0	0	0	0	0	0	0	0	0	0	0
Amberlie Ezell	Memphis	Nov. 5, 2016	West Virginia	72	94	92	99	88	96	541	0	94	96	98	100	95	96	579	0
Amy Fister	Memphis	Nov. 5, 2016	West Virginia	96	98	100	98	95	95	582	0	96	97	97	99	99	95	583	0
Eli Rischling	Memphis	Nov. 5, 2016	West Virginia	97	95	99	98	87	93	569	0	0	0	0	0	0	0	0	0
Abby Votava	Memphis	Nov. 5, 2016	West Virginia	95	97	97	97	93	91	570	0	94	95	95	93	92	96	565	0
Deanna Binnie	Ohio State	Nov. 5, 2016	UTEP	0	0	0	0	0	0	0	0	0	0	0	0	0	0	0	0
Josh Black	Ohio State	Nov. 5, 2016	UTEP	96	99	98	99	90	93	575	0	99	98	96	99	98	98	588	0
Jacob Buchanan	Ohio State	Nov. 5, 2016	UTEP	93	94	100	98	97	96	578	0	99	98	98	98	96	100	589	0
Drew Cheezum	Ohio State	Nov. 5, 2016	UTEP	94	97	98	97	97	98	581	0	99	100	98	100	98	99	594	0
Anthony Cuozzo	Ohio State	Nov. 5, 2016	UTEP	0	0	0	0	0	0	0	0	0	0	0	0	0	0	0	0
Kendal Elder	Ohio State	Nov. 5, 2016	UTEP	0	0	0	0	0	0	0	0	0	0	0	0	0	0	0	0
Alli Kissell	Ohio State	Nov. 5, 2016	UTEP	0	0	0	0	0	0	0	0	0	0	0	0	0	0	0	0
Mark Matheny	Ohio State	Nov. 5, 2016	UTEP	99	96	98	99	94	91	577	0	100	98	96	99	100	99	592	0
Patrick Sardo	Ohio State	Nov. 5, 2016	UTEP	0	0	0	0	0	0	0	0	0	0	0	0	0	0	0	0
Michael Steinel	Ohio State	Nov. 5, 2016	UTEP	97	92	96	100	93	94	572	0	98	99	99	99	100	97	592	0
Chrissy Thomas	Ohio State	Nov. 5, 2016	UTEP	0	0	0	0	0	0	0	0	0	0	0	0	0	0	0	0
Rhiann Travis	Ohio State	Nov. 5, 2016	UTEP	92	92	96	97	95	95	567	0	98	97	98	98	98	97	586	0
Bailey Urbach	Ohio State	Nov. 5, 2016	UTEP	0	0	0	0	0	0	0	0	0	0	0	0	0	0	0	0
Brendan Whitaker	Ohio State	Nov. 5, 2016	UTEP	0	0	0	0	0	0	0	0	0	0	0	0	0	0	0	0
Quintin Wotring	Ohio State	Nov. 5, 2016	UTEP	95	89	98	99	91	91	563	0	94	94	96	98	94	96	572	0
Nicholle Benedict	TCU	Nov. 5, 2016	UTEP	0	0	0	0	0	0	0	0	0	0	0	0	0	0	0	0
Katie Bridges	TCU	Nov. 5, 2016	UTEP	0	0	0	0	0	0	0	0	0	0	0	0	0	0	0	0
Rachel Garner	TCU	Nov. 5, 2016	UTEP	97	95	99	98	95	92	576	0	100	100	100	96	98	99	593	0
Ariana Grabowski	TCU	Nov. 5, 2016	UTEP	97	98	99	99	91	95	579	0	96	97	98	99	96	96	582	0
Emily Haag	TCU	Nov. 5, 2016	UTEP	95	94	99	97	92	89	566	0	94	97	98	94	97	97	577	0
Nicole Hankey	TCU	Nov. 5, 2016	UTEP	97	96	99	99	93	94	578	0	96	98	96	98	98	96	582	0
Rachel Kimbell	TCU	Nov. 5, 2016	UTEP	94	100	98	100	88	87	567	0	96	98	99	98	96	98	585	0
Sally Li	TCU	Nov. 5, 2016	UTEP	97	98	99	100	96	95	585	0	98	99	95	94	97	94	577	0
Casey Lutz	TCU	Nov. 5, 2016	UTEP	95	99	99	98	99	91	581	0	99	98	99	100	99	98	593	0
Mindy Miles	TCU	Nov. 5, 2016	UTEP	94	89	99	99	95	99	575	0	99	99	99	100	100	100	597	0
Catherine Miller	TCU	Nov. 5, 2016	UTEP	93	92	96	96	95	97	569	0	95	99	99	100	98	100	591	0
Meraleigh Randle	TCU	Nov. 5, 2016	UTEP	0	0	0	0	0	0	0	0	0	0	0	0	0	0	0	0
Barrett Ray	TCU	Nov. 5, 2016	UTEP	95	94	99	98	94	94	574	0	96	94	96	95	94	95	570	0
Rachel Hubal	USciences	Nov. 5, 2016	VMI	0	0	0	0	0	0	0	0	73	87	81	91	83	87	502	0
Angela Kang	USciences	Nov. 5, 2016	VMI	85	87	90	88	85	86	521	0	82	92	84	87	92	92	529	0
Brittany Mahoney	USciences	Nov. 5, 2016	VMI	0	0	0	0	0	0	0	0	0	0	0	0	0	0	0	0
Chris Makosiej	USciences	Nov. 5, 2016	VMI	0	0	0	0	0	0	0	0	0	0	0	0	0	0	0	0
Nick Makosiej	USciences	Nov. 5, 2016	VMI	0	0	0	0	0	0	0	0	0	0	0	0	0	0	0	0
Thomas Nelligan	USciences	Nov. 5, 2016	VMI	0	0	0	0	0	0	0	0	0	0	0	0	0	0	0	0
Matt Popowicz	USciences	Nov. 5, 2016	VMI	87	86	94	94	85	77	523	0	86	90	86	94	89	85	530	0
Andrej Quatrone	USciences	Nov. 5, 2016	VMI	0	0	0	0	0	0	0	0	87	80	85	84	88	80	504	0
Sarah Schnupp	USciences	Nov. 5, 2016	VMI	96	94	99	96	91	88	564	0	98	99	93	97	97	97	581	0
Lauren Stabler	USciences	Nov. 5, 2016	VMI	0	0	0	0	0	0	0	0	81	86	85	89	92	86	519	0
Christina Tipton	USciences	Nov. 5, 2016	VMI	0	0	0	0	0	0	0	0	0	0	0	0	0	0	0	0
Allie Tuman	USciences	Nov. 5, 2016	VMI	0	0	0	0	0	0	0	0	87	85	78	86	94	86	516	0
Anita Varkey	USciences	Nov. 5, 2016	VMI	0	0	0	0	0	0	0	0	0	0	0	0	0	0	0	0
Andrew Visconti	USciences	Nov. 5, 2016	VMI	92	92	98	94	81	85	542	0	88	95	83	96	91	86	539	0
Nick Zsoldos	USciences	Nov. 5, 2016	VMI	92	88	92	88	70	76	506	0	90	89	88	94	90	86	537	0
William Davidson	VMI	Nov. 5, 2016	VMI	89	91	96	97	96	84	553	0	97	94	93	96	96	94	570	0
Andrew Hickey	VMI	Nov. 5, 2016	VMI	89	91	97	100	89	90	556	0	94	97	95	96	96	95	573	0
Jacob Hunter	VMI	Nov. 5, 2016	VMI	89	86	98	97	84	88	542	0	94	97	95	97	98	98	579	0
Zachary Johnson	VMI	Nov. 5, 2016	VMI	92	90	97	96	88	92	555	0	0	0	0	0	0	0	0	0
Mathew Lusardi	VMI	Nov. 5, 2016	VMI	89	93	98	95	84	88	547	0	0	0	0	0	0	0	0	0
Chris Milliken	VMI	Nov. 5, 2016	VMI	0	0	0	0	0	0	0	0	93	95	93	96	96	95	568	0
John Pitman	VMI	Nov. 5, 2016	VMI	90	91	99	96	84	83	543	0	0	0	0	0	0	0	0	0
Nick Reynolds	VMI	Nov. 5, 2016	VMI	96	94	95	95	93	88	561	0	94	94	93	92	95	96	564	0
Kelia Aardema	VMI (W)	Nov. 5, 2016	VMI	0	0	0	0	0	0	0	0	89	86	94	88	80	82	519	0
Samantha Alexander	VMI (W)	Nov. 5, 2016	VMI	90	97	93	97	93	89	559	0	95	93	93	94	95	96	566	0
Ellana Avery	VMI (W)	Nov. 5, 2016	VMI	87	93	96	97	72	78	523	0	0	0	0	0	0	0	0	0
Sabrina Bell	VMI (W)	Nov. 5, 2016	VMI	0	0	0	0	0	0	0	0	92	86	97	93	90	90	548	0
Alice Chiu	VMI (W)	Nov. 5, 2016	VMI	0	0	0	0	0	0	0	0	0	0	0	0	0	0	0	0
Jamie Foster	VMI (W)	Nov. 5, 2016	VMI	0	0	0	0	0	0	0	0	78	83	89	84	82	81	497	0
Joelle Henry	VMI (W)	Nov. 5, 2016	VMI	0	0	0	0	0	0	0	0	88	89	89	89	86	88	529	0
Rachel Jankelow	VMI (W)	Nov. 5, 2016	VMI	94	89	95	94	84	74	530	0	93	94	91	95	92	96	561	0
Kerrie Lightfoot	VMI (W)	Nov. 5, 2016	VMI	78	81	88	92	82	84	505	0	96	93	94	94	93	91	561	0
Loyce Lightfoot	VMI (W)	Nov. 5, 2016	VMI	92	88	93	92	93	92	550	0	88	91	91	91	86	92	539	0
Kaitlyn Morrison	VMI (W)	Nov. 5, 2016	VMI	0	0	0	0	0	0	0	0	0	0	0	0	0	0	0	0
Katherine Watson	VMI (W)	Nov. 5, 2016	VMI	84	89	98	92	89	90	542	0	90	96	89	89	92	91	547	0
Lauryn Cinadr	Akron	Nov. 5, 2016	Kentucky	0	0	0	0	0	0	0	0	0	0	0	0	0	0	0	0
Alex Fedorko	Akron	Nov. 5, 2016	Kentucky	91	88	95	97	90	87	548	0	97	95	96	96	96	93	573	0
Sydney Goldschlag	Akron	Nov. 5, 2016	Kentucky	92	94	96	99	85	89	555	0	93	94	99	97	95	95	573	0
Rebecca Green	Akron	Nov. 5, 2016	Kentucky	0	0	0	0	0	0	0	0	0	0	0	0	0	0	0	0
Julia Hatch	Akron	Nov. 5, 2016	Kentucky	96	95	96	96	91	87	561	0	92	96	96	100	96	97	577	0
Anthony Jackson	Akron	Nov. 5, 2016	Kentucky	93	90	99	99	91	91	563	0	98	96	97	97	97	96	581	0
Kera Kaufman	Akron	Nov. 5, 2016	Kentucky	0	0	0	0	0	0	0	0	0	0	0	0	0	0	0	0
Joshua Kovach	Akron	Nov. 5, 2016	Kentucky	90	91	99	99	94	93	566	0	97	98	92	98	98	95	578	0
Caleb Lloyd	Akron	Nov. 5, 2016	Kentucky	98	95	100	100	93	92	578	0	97	97	98	98	96	96	582	0
Danielle Makucevich	Akron	Nov. 5, 2016	Kentucky	0	0	0	0	0	0	0	0	0	0	0	0	0	0	0	0
Kris Mantel	Akron	Nov. 5, 2016	Kentucky	0	0	0	0	0	0	0	0	0	0	0	0	0	0	0	0
Brent Morgan	Akron	Nov. 5, 2016	Kentucky	0	0	0	0	0	0	0	0	0	0	0	0	0	0	0	0
Connor O'Mara	Akron	Nov. 5, 2016	Kentucky	96	93	100	99	96	96	580	0	97	97	97	98	97	99	585	0
Marlee Reynolds	Akron	Nov. 5, 2016	Kentucky	0	0	0	0	0	0	0	0	0	0	0	0	0	0	0	0
Sean Roehrs	Akron	Nov. 5, 2016	Kentucky	95	95	98	94	94	85	561	0	96	94	99	95	92	97	573	0
Zach Strohl	Akron	Nov. 5, 2016	Kentucky	98	92	98	99	96	91	574	0	98	98	98	98	98	98	588	0
Cierra Terrizzi	Akron	Nov. 5, 2016	Kentucky	97	97	99	98	93	92	576	0	95	99	99	97	97	98	585	0
Katie Brown	Nebraska	Nov. 5, 2016	Kentucky	0	0	0	0	0	0	0	0	0	0	0	0	0	0	0	0
Jaycee Carter	Nebraska	Nov. 5, 2016	Kentucky	93	90	98	100	92	96	569	0	99	98	97	93	98	98	583	0
Dacotah Faught	Nebraska	Nov. 5, 2016	Kentucky	96	94	100	99	96	96	581	0	99	99	99	98	98	100	593	0
Kayla Gadeken	Nebraska	Nov. 5, 2016	Kentucky	93	93	96	97	95	95	569	0	97	99	98	99	97	100	590	0
Maddie Korthas	Nebraska	Nov. 5, 2016	Kentucky	0	0	0	0	0	0	0	0	0	0	0	0	0	0	0	0
Rachel Martin	Nebraska	Nov. 5, 2016	Kentucky	96	97	99	100	94	96	582	0	98	99	97	100	99	99	592	0
Jordan Miller	Nebraska	Nov. 5, 2016	Kentucky	0	0	0	0	0	0	0	0	0	0	0	0	0	0	0	0
Samantha Peterson	Nebraska	Nov. 5, 2016	Kentucky	95	98	98	99	97	95	582	0	96	99	98	97	96	94	580	0
Nina Radulovic	Nebraska	Nov. 5, 2016	Kentucky	94	93	99	100	89	95	570	0	96	93	94	96	97	97	573	0
Sarah Sutton	Nebraska	Nov. 5, 2016	Kentucky	0	0	0	0	0	0	0	0	0	0	0	0	0	0	0	0
Hannah Virga	Nebraska	Nov. 5, 2016	Kentucky	97	97	91	95	91	93	564	0	0	0	0	0	0	0	0	0
Rachel Yager	Nebraska	Nov. 5, 2016	Kentucky	97	95	99	98	93	90	572	0	98	95	95	94	93	97	572	0
Spencer Brandon	Air Force	Nov. 5, 2016	Air Force	95	90	97	95	90	93	560	0	99	100	97	99	97	96	588	0
Spencer Cap	Air Force	Nov. 5, 2016	Air Force	94	96	99	99	98	97	583	0	99	100	100	100	100	99	598	0
Kyle Cox	Air Force	Nov. 5, 2016	Air Force	0	0	0	0	0	0	0	0	94	97	93	96	95	91	566	0
Ryan Jacobs	Air Force	Nov. 5, 2016	Air Force	95	98	99	99	97	96	584	0	99	99	100	97	100	100	595	0
Noah Kwock	Air Force	Nov. 5, 2016	Air Force	0	0	0	0	0	0	0	0	0	0	0	0	0	0	0	0
Nick Learn	Air Force	Nov. 5, 2016	Air Force	93	96	95	99	92	96	571	0	95	99	100	98	97	100	589	0
Logan Ogden	Air Force	Nov. 5, 2016	Air Force	97	96	98	98	94	94	577	0	99	100	99	99	99	97	593	0
Mary Simonton	Air Force	Nov. 5, 2016	Air Force	0	0	0	0	0	0	0	0	0	0	0	0	0	0	0	0
Anna Weilbacher	Air Force	Nov. 5, 2016	Air Force	96	96	99	100	93	94	578	0	97	98	99	97	100	99	590	0
Nathan Brewer	Army	Nov. 5, 2016	Air Force	96	98	100	100	93	96	583	0	100	99	100	97	98	98	592	0
Emiliano Concha-Toro	Army	Nov. 5, 2016	Air Force	90	91	99	98	81	93	552	0	95	98	97	95	98	99	582	0
Ethan Cook	Army	Nov. 5, 2016	Air Force	94	93	99	95	92	89	562	0	90	95	94	95	96	99	569	0
Danielle Cuomo	Army	Nov. 5, 2016	Air Force	95	98	99	98	93	90	573	0	100	99	94	98	97	100	588	0
Maggie Ehmann	Army	Nov. 5, 2016	Air Force	0	0	0	0	0	0	0	0	0	0	0	0	0	0	0	0
Maddy Erikson	Army	Nov. 5, 2016	Air Force	0	0	0	0	0	0	0	0	98	98	97	96	96	97	582	0
Mike Garner	Army	Nov. 5, 2016	Air Force	94	96	96	99	87	89	561	0	0	0	0	0	0	0	0	0
Nick Kanellis	Army	Nov. 5, 2016	Air Force	0	0	0	0	0	0	0	0	0	0	0	0	0	0	0	0
Marvin Lewis	Army	Nov. 5, 2016	Air Force	96	95	98	98	93	95	575	0	98	96	97	96	95	98	580	0
Rhianna Lichtenthal	Army	Nov. 5, 2016	Air Force	0	0	0	0	0	0	0	0	0	0	0	0	0	0	0	0
Libby Mostert	Army	Nov. 5, 2016	Air Force	0	0	0	0	0	0	0	0	0	0	0	0	0	0	0	0
Sarah Nakata	Army	Nov. 5, 2016	Air Force	0	0	0	0	0	0	0	0	0	0	0	0	0	0	0	0
Payne Nunn	Army	Nov. 5, 2016	Air Force	95	96	99	98	92	91	571	0	92	96	98	99	99	98	582	0
Allen Solida	Army	Nov. 5, 2016	Air Force	95	94	100	99	89	91	568	0	97	95	95	98	96	96	577	0
Andrew Solomonides	Army	Nov. 5, 2016	Air Force	0	0	0	0	0	0	0	0	0	0	0	0	0	0	0	0
Melissa Brizzi	Coast Guard	Nov. 5, 2016	Air Force	92	84	94	94	80	82	526	0	93	92	90	90	91	86	542	0
Joseph Busching	Coast Guard	Nov. 5, 2016	Air Force	0	0	0	0	0	0	0	0	0	0	0	0	0	0	0	0
Jacob Dupree	Coast Guard	Nov. 5, 2016	Air Force	88	86	93	96	74	77	514	0	95	91	91	89	91	93	550	0
Randall Ford	Coast Guard	Nov. 5, 2016	Air Force	85	93	99	95	92	92	556	0	94	97	95	98	93	91	568	0
Marshall Grant	Coast Guard	Nov. 5, 2016	Air Force	82	91	90	93	79	81	516	0	84	88	83	86	95	89	525	0
Alexandria Harrington	Coast Guard	Nov. 5, 2016	Air Force	91	96	96	97	93	92	565	0	96	97	97	95	94	95	574	0
Anthony Lee	Coast Guard	Nov. 5, 2016	Air Force	0	0	0	0	0	0	0	0	0	0	0	0	0	0	0	0
Dylan Lorence	Coast Guard	Nov. 5, 2016	Air Force	0	0	0	0	0	0	0	0	0	0	0	0	0	0	0	0
Kaden Nichols	Coast Guard	Nov. 5, 2016	Air Force	0	0	0	0	0	0	0	0	0	0	0	0	0	0	0	0
Nicholas Paisker	Coast Guard	Nov. 5, 2016	Air Force	89	95	99	96	89	87	555	0	96	99	97	96	95	97	580	0
Paul Raynolds	Coast Guard	Nov. 5, 2016	Air Force	0	0	0	0	0	0	0	0	0	0	0	0	0	0	0	0
David Rose	Coast Guard	Nov. 5, 2016	Air Force	0	0	0	0	0	0	0	0	0	0	0	0	0	0	0	0
Alaric Stone	Coast Guard	Nov. 5, 2016	Air Force	0	0	0	0	0	0	0	0	0	0	0	0	0	0	0	0
Nyjah Turner	Coast Guard	Nov. 5, 2016	Air Force	0	0	0	0	0	0	0	0	0	0	0	0	0	0	0	0
Lucas Figi	Navy	Nov. 5, 2016	Air Force	0	0	0	0	0	0	0	0	0	0	0	0	0	0	0	0
Maggie Guetersloh	Navy	Nov. 5, 2016	Air Force	94	92	97	96	92	84	555	0	98	94	95	96	95	97	575	0
Amy Hammer	Navy	Nov. 5, 2016	Air Force	0	0	0	0	0	0	0	0	0	0	0	0	0	0	0	0
Daniel Jonas	Navy	Nov. 5, 2016	Air Force	95	94	98	99	93	96	575	0	99	99	97	98	97	96	586	0
Kestrel Kuhne	Navy	Nov. 5, 2016	Air Force	87	94	97	97	94	95	564	0	96	98	98	99	98	96	585	0
Alex Muzzioli	Navy	Nov. 5, 2016	Air Force	92	96	97	98	89	92	564	0	95	95	97	99	96	96	578	0
Brandon Pippin	Navy	Nov. 5, 2016	Air Force	87	87	92	94	83	84	527	0	98	94	96	93	96	96	573	0
Nash Richardson	Navy	Nov. 5, 2016	Air Force	93	96	99	99	90	89	566	0	94	95	97	89	96	98	569	0
Thomas Sarant	Navy	Nov. 5, 2016	Air Force	91	92	98	98	95	92	566	0	93	98	100	98	99	98	586	0
Josh Watson	Navy	Nov. 5, 2016	Air Force	93	93	98	96	92	93	565	0	96	99	94	96	99	93	577	0
Andrew Abernathy	North Georgia	Nov. 6, 2016	North Georgia	0	0	0	0	0	0	0	0	0	0	0	0	0	0	0	0
Eric Azotea	North Georgia	Nov. 6, 2016	North Georgia	0	0	0	0	0	0	0	0	0	0	0	0	0	0	0	0
Ruthanne Conner	North Georgia	Nov. 6, 2016	North Georgia	95	91	99	100	94	94	573	0	98	98	94	98	97	96	581	0
Lucas Gilliland	North Georgia	Nov. 6, 2016	North Georgia	0	0	0	0	0	0	0	0	0	0	0	0	0	0	0	0
Maddie Godwin	North Georgia	Nov. 6, 2016	North Georgia	0	0	0	0	0	0	0	0	0	0	0	0	0	0	0	0
Hannah Peevy	North Georgia	Nov. 6, 2016	North Georgia	0	0	0	0	0	0	0	0	0	0	0	0	0	0	0	0
Jared Rice	North Georgia	Nov. 6, 2016	North Georgia	88	91	95	95	94	97	560	0	98	96	96	96	96	83	565	0
Tobin Sanctuary	North Georgia	Nov. 6, 2016	North Georgia	97	95	96	97	92	92	569	0	0	0	0	0	0	0	0	0
Brianna Shaw	North Georgia	Nov. 6, 2016	North Georgia	0	0	0	0	0	0	0	0	0	0	0	0	0	0	0	0
Dakota Spivey	North Georgia	Nov. 6, 2016	North Georgia	91	95	97	98	93	96	570	0	99	97	98	99	97	98	588	0
David Turner	North Georgia	Nov. 6, 2016	North Georgia	0	0	0	0	0	0	0	0	93	97	97	95	95	98	575	0
Alex Bapties	UT Martin	Nov. 6, 2016	North Georgia	90	92	94	97	85	87	545	0	95	90	93	97	90	93	558	0
Brigitte Curcio	UT Martin	Nov. 6, 2016	North Georgia	96	92	99	97	92	95	571	0	98	97	96	98	95	95	579	0
Andre Delcalzo	UT Martin	Nov. 6, 2016	North Georgia	91	84	93	97	85	83	533	0	0	0	0	0	0	0	0	0
Logan Hunt	UT Martin	Nov. 6, 2016	North Georgia	0	0	0	0	0	0	0	0	95	96	96	94	98	93	572	0
Kaitlin Korinek	UT Martin	Nov. 6, 2016	North Georgia	89	93	96	99	94	92	563	0	100	97	97	98	100	98	590	0
Joe Martin	UT Martin	Nov. 6, 2016	North Georgia	93	97	99	99	97	94	579	0	98	95	98	95	98	99	583	0
Alex Tamboli	UT Martin	Nov. 6, 2016	North Georgia	94	95	96	98	83	93	559	0	95	96	93	97	93	92	566	0
Rosemary Kramer	Ga. Southern	Nov. 6, 2016	North Georgia	91	96	96	98	88	89	558	0	96	96	97	94	97	78	558	0
Tori Lewis	Ga. Southern	Nov. 6, 2016	North Georgia	94	95	94	95	93	87	558	0	92	99	97	97	98	96	579	0
Jennifer Middlebrook	Ga. Southern	Nov. 6, 2016	North Georgia	0	0	0	0	0	0	0	0	0	0	0	0	0	0	0	0
Lydia Odlin	Ga. Southern	Nov. 6, 2016	North Georgia	93	90	98	94	77	86	538	0	95	93	94	94	96	97	569	0
Chastity Price	Ga. Southern	Nov. 6, 2016	North Georgia	82	90	91	88	83	81	515	0	97	88	93	96	90	89	553	0
Courtney Weekley	Ga. Southern	Nov. 6, 2016	North Georgia	89	88	95	95	88	93	548	0	93	97	99	98	94	97	578	0
Kathryn Youngblood	Ga. Southern	Nov. 6, 2016	North Georgia	0	0	0	0	0	0	0	0	0	0	0	0	0	0	0	0
Erin Bell	UT Martin (W)	Nov. 6, 2016	North Georgia	0	0	0	0	0	0	0	0	0	0	0	0	0	0	0	0
Ashley Coots	UT Martin (W)	Nov. 6, 2016	North Georgia	94	94	98	93	83	87	549	0	97	92	94	93	94	90	560	0
Lindsey Flint	UT Martin (W)	Nov. 6, 2016	North Georgia	92	88	95	92	88	84	539	0	0	0	0	0	0	0	0	0
Amanda Mayo	UT Martin (W)	Nov. 6, 2016	North Georgia	0	0	0	0	0	0	0	0	96	91	96	96	96	95	570	0
Jennifer Plocinik	UT Martin (W)	Nov. 6, 2016	North Georgia	93	96	97	97	93	92	568	0	98	94	93	96	97	98	576	0
Brianna Sawyers	UT Martin (W)	Nov. 6, 2016	North Georgia	91	93	97	98	93	85	557	0	94	100	99	98	98	99	588	0
Alyson Sylvester	UT Martin (W)	Nov. 6, 2016	North Georgia	92	92	98	95	92	93	562	0	92	96	96	97	96	97	574	0
Soren Butler	Alaska Fairbanks	Nov. 6, 2016	Nevada Reno	99	94	98	99	95	96	581	0	98	98	98	99	99	99	591	0
Liam Eberhart	Alaska Fairbanks	Nov. 6, 2016	Nevada Reno	0	0	0	0	0	0	0	0	0	0	0	0	0	0	0	0
Amy Gentry	Alaska Fairbanks	Nov. 6, 2016	Nevada Reno	95	97	98	94	92	90	566	0	97	96	96	97	95	97	578	0
Luke Johnson	Alaska Fairbanks	Nov. 6, 2016	Nevada Reno	95	99	95	99	92	97	577	0	99	95	97	98	98	97	584	0
Sagen Maddalena	Alaska Fairbanks	Nov. 6, 2016	Nevada Reno	99	98	100	99	96	99	591	0	98	99	99	98	98	100	592	0
Grace Nelson	Alaska Fairbanks	Nov. 6, 2016	Nevada Reno	0	0	0	0	0	0	0	0	0	0	0	0	0	0	0	0
JT Schnering	Alaska Fairbanks	Nov. 6, 2016	Nevada Reno	94	98	97	95	91	97	572	0	98	99	98	97	97	86	575	0
Robert Scott	Alaska Fairbanks	Nov. 6, 2016	Nevada Reno	93	92	99	96	90	95	565	0	98	98	97	98	98	99	588	0
Nathan Taylor	Alaska Fairbanks	Nov. 6, 2016	Nevada Reno	0	0	0	0	0	0	0	0	0	0	0	0	0	0	0	0
Rachel Benesh	Nevada	Nov. 6, 2016	Nevada Reno	94	93	97	100	94	88	566	0	98	97	99	98	99	99	590	0
Emily Capaul	Nevada	Nov. 6, 2016	Nevada Reno	95	94	99	98	94	96	576	0	97	98	97	99	99	99	589	0
Jared Crews	Nevada	Nov. 6, 2016	Nevada Reno	0	0	0	0	0	0	0	0	0	0	0	0	0	0	0	0
Maneva Gill	Nevada	Nov. 6, 2016	Nevada Reno	0	0	0	0	0	0	0	0	0	0	0	0	0	0	0	0
Sarah Jameson	Nevada	Nov. 6, 2016	Nevada Reno	97	92	97	97	87	95	565	0	99	97	98	100	98	98	590	0
Eli Larimer	Nevada	Nov. 6, 2016	Nevada Reno	96	93	100	100	95	95	579	0	97	96	96	99	97	96	581	0
Justin Nissen	Nevada	Nov. 6, 2016	Nevada Reno	94	91	98	99	92	95	569	0	98	97	95	98	98	95	581	0
Jami Sexton	Nevada	Nov. 6, 2016	Nevada Reno	0	0	0	0	0	0	0	0	0	0	0	0	0	0	0	0
Sara Tashima	Nevada	Nov. 6, 2016	Nevada Reno	0	0	0	0	0	0	0	0	0	0	0	0	0	0	0	0
Mitchell Van Patten	Nevada	Nov. 6, 2016	Nevada Reno	97	94	96	98	90	93	568	0	98	100	98	99	98	100	593	0
Deanna Binnie	Ohio State	Nov. 6, 2016	UTEP	0	0	0	0	0	0	0	0	0	0	0	0	0	0	0	0
Josh Black	Ohio State	Nov. 6, 2016	UTEP	98	95	96	96	93	98	576	0	96	99	98	97	98	97	585	0
Jacob Buchanan	Ohio State	Nov. 6, 2016	UTEP	100	96	99	98	95	92	580	0	99	97	98	100	100	97	591	0
Drew Cheezum	Ohio State	Nov. 6, 2016	UTEP	96	96	99	98	99	95	583	0	98	97	98	99	99	99	590	0
Anthony Cuozzo	Ohio State	Nov. 6, 2016	UTEP	0	0	0	0	0	0	0	0	0	0	0	0	0	0	0	0
Kendal Elder	Ohio State	Nov. 6, 2016	UTEP	0	0	0	0	0	0	0	0	0	0	0	0	0	0	0	0
Alli Kissell	Ohio State	Nov. 6, 2016	UTEP	0	0	0	0	0	0	0	0	0	0	0	0	0	0	0	0
Mark Matheny	Ohio State	Nov. 6, 2016	UTEP	93	95	98	98	95	96	575	0	98	99	99	95	98	98	587	0
Patrick Sardo	Ohio State	Nov. 6, 2016	UTEP	0	0	0	0	0	0	0	0	0	0	0	0	0	0	0	0
Michael Steinel	Ohio State	Nov. 6, 2016	UTEP	94	96	100	99	92	92	573	0	97	99	100	100	100	98	594	0
Chrissy Thomas	Ohio State	Nov. 6, 2016	UTEP	0	0	0	0	0	0	0	0	0	0	0	0	0	0	0	0
Rhiann Travis	Ohio State	Nov. 6, 2016	UTEP	96	94	97	88	94	87	556	0	97	98	99	97	98	97	586	0
Bailey Urbach	Ohio State	Nov. 6, 2016	UTEP	0	0	0	0	0	0	0	0	0	0	0	0	0	0	0	0
Brendan Whitaker	Ohio State	Nov. 6, 2016	UTEP	0	0	0	0	0	0	0	0	0	0	0	0	0	0	0	0
Quintin Wotring	Ohio State	Nov. 6, 2016	UTEP	0	0	0	0	0	0	0	0	0	0	0	0	0	0	0	0
Jessica Kinder	UTEP	Nov. 6, 2016	UTEP	0	0	0	0	0	0	0	0	96	96	98	96	95	97	578	0
Abby Monique	UTEP	Nov. 6, 2016	UTEP	83	88	97	96	90	93	547	0	98	99	95	93	96	90	571	0
Maranda Nelson	UTEP	Nov. 6, 2016	UTEP	88	87	94	96	89	79	533	0	99	97	98	94	93	98	579	0
Bailey Powell	UTEP	Nov. 6, 2016	UTEP	97	94	96	98	88	93	566	0	97	99	96	98	99	100	589	0
Mara Rouse	UTEP	Nov. 6, 2016	UTEP	97	94	97	96	91	90	565	0	100	98	97	98	99	99	591	0
Rachael Schoenrock	UTEP	Nov. 6, 2016	UTEP	98	94	97	96	92	92	569	0	99	97	97	96	97	95	581	0
Haylee Schoenrock	UTEP	Nov. 6, 2016	UTEP	93	95	99	94	92	92	565	0	96	96	95	98	99	97	581	0
Monthserrat Serna	UTEP	Nov. 6, 2016	UTEP	0	0	0	0	0	0	0	0	97	90	92	97	97	91	564	0
Billy Azzinaro	Kentucky	Nov. 6, 2016	Kentucky	93	96	99	99	97	94	578	0	99	97	99	98	99	99	591	0
Jenna Bethea	Kentucky	Nov. 6, 2016	Kentucky	93	91	100	100	88	93	565	0	97	97	99	99	97	99	588	0
Hanna Carr	Kentucky	Nov. 6, 2016	Kentucky	95	96	98	100	96	100	585	0	96	99	99	95	97	97	583	0
Morgan Duerr	Kentucky	Nov. 6, 2016	Kentucky	94	93	99	99	84	91	560	0	96	95	97	96	97	94	575	0
Ian Foos	Kentucky	Nov. 6, 2016	Kentucky	88	93	97	96	91	95	560	0	95	99	99	97	96	98	584	0
Carmen Fry	Kentucky	Nov. 6, 2016	Kentucky	93	96	98	98	90	93	568	0	96	98	94	98	93	98	577	0
Heather Kirby	Kentucky	Nov. 6, 2016	Kentucky	94	90	97	99	96	94	570	0	99	100	100	99	100	100	598	0
Sonya May	Kentucky	Nov. 6, 2016	Kentucky	95	94	98	100	93	92	572	0	93	99	96	95	94	97	574	0
Andrew Miller	Kentucky	Nov. 6, 2016	Kentucky	95	87	93	99	81	87	542	0	95	98	96	97	95	94	575	0
Cathryn Papasodora	Kentucky	Nov. 6, 2016	Kentucky	96	95	97	98	95	94	575	0	98	99	100	99	98	98	592	0
Jason Scharbel	Kentucky	Nov. 6, 2016	Kentucky	98	97	100	97	92	88	572	0	96	100	100	95	97	99	587	0
Jason Spaude	Kentucky	Nov. 6, 2016	Kentucky	97	97	99	100	94	92	579	0	95	99	97	99	99	99	588	0
Katie Brown	Nebraska	Nov. 6, 2016	Kentucky	0	0	0	0	0	0	0	0	0	0	0	0	0	0	0	0
Jaycee Carter	Nebraska	Nov. 6, 2016	Kentucky	94	95	98	98	95	97	577	0	96	98	98	99	99	98	588	0
Dacotah Faught	Nebraska	Nov. 6, 2016	Kentucky	96	96	97	100	95	94	578	0	99	99	98	100	100	100	596	0
Kayla Gadeken	Nebraska	Nov. 6, 2016	Kentucky	89	96	95	99	85	95	559	0	99	98	96	99	97	98	587	0
Maddie Korthas	Nebraska	Nov. 6, 2016	Kentucky	0	0	0	0	0	0	0	0	0	0	0	0	0	0	0	0
Rachel Martin	Nebraska	Nov. 6, 2016	Kentucky	97	91	99	98	93	91	569	0	95	98	98	100	100	99	590	0
Jordan Miller	Nebraska	Nov. 6, 2016	Kentucky	0	0	0	0	0	0	0	0	0	0	0	0	0	0	0	0
Samantha Peterson	Nebraska	Nov. 6, 2016	Kentucky	100	92	100	100	92	96	580	0	97	98	98	97	99	99	588	0
Nina Radulovic	Nebraska	Nov. 6, 2016	Kentucky	97	98	100	100	94	97	586	0	97	95	96	98	99	99	584	0
Sarah Sutton	Nebraska	Nov. 6, 2016	Kentucky	0	0	0	0	0	0	0	0	0	0	0	0	0	0	0	0
Hannah Virga	Nebraska	Nov. 6, 2016	Kentucky	0	0	0	0	0	0	0	0	0	0	0	0	0	0	0	0
Rachel Yager	Nebraska	Nov. 6, 2016	Kentucky	92	98	97	98	88	94	567	0	94	98	98	100	98	98	586	0
Nathan Brewer	Army	Nov. 11, 2016	Army	96	96	99	99	95	97	582	25	97	99	99	98	99	99	591	46
Emiliano Concha-Toro	Army	Nov. 11, 2016	Army	93	94	100	97	92	93	569	23	94	95	97	99	98	97	580	31
Ethan Cook	Army	Nov. 11, 2016	Army	97	94	99	98	91	93	572	23	99	98	97	96	98	95	583	32
Danielle Cuomo	Army	Nov. 11, 2016	Army	95	95	99	99	97	92	577	19	98	98	100	97	98	95	586	33
Maggie Ehmann	Army	Nov. 11, 2016	Army	93	98	98	97	95	88	569	19	92	92	92	95	96	91	558	18
Maddy Erikson	Army	Nov. 11, 2016	Army	93	95	99	98	93	95	573	23	97	98	97	99	98	99	588	41
Mike Garner	Army	Nov. 11, 2016	Army	91	80	87	96	87	89	530	10	98	98	97	99	95	98	585	35
Nick Kanellis	Army	Nov. 11, 2016	Army	96	94	94	95	96	89	564	15	96	96	96	99	98	96	581	31
Marvin Lewis	Army	Nov. 11, 2016	Army	97	95	97	99	96	96	580	29	98	100	92	98	97	99	584	31
Rhianna Lichtenthal	Army	Nov. 11, 2016	Army	93	94	95	97	85	97	561	20	98	95	98	97	96	94	578	31
Libby Mostert	Army	Nov. 11, 2016	Army	90	94	95	97	93	96	565	18	94	98	96	95	96	98	577	27
Sarah Nakata	Army	Nov. 11, 2016	Army	0	0	0	0	0	0	0	0	97	99	96	98	97	94	581	35
Payne Nunn	Army	Nov. 11, 2016	Army	96	94	99	98	93	91	571	25	96	98	99	97	96	98	584	38
Allen Solida	Army	Nov. 11, 2016	Army	98	100	99	99	93	93	582	30	99	97	99	97	95	93	580	35
Andrew Solomonides	Army	Nov. 11, 2016	Army	95	92	98	98	87	96	566	18	96	96	95	94	94	96	571	19
Hayley Carroll	Ole Miss	Nov. 11, 2016	Army	94	93	100	99	93	92	571	24	97	98	98	98	96	95	582	36
Harley Gardner	Ole Miss	Nov. 11, 2016	Army	94	95	99	99	93	96	576	27	99	99	99	96	99	99	591	37
Jess Haig	Ole Miss	Nov. 11, 2016	Army	94	95	97	98	94	96	574	27	98	97	98	96	99	99	587	37
Alana Kelly	Ole Miss	Nov. 11, 2016	Army	93	88	100	98	89	92	560	23	95	95	96	96	99	93	574	0
Randi Loudin	Ole Miss	Nov. 11, 2016	Army	0	0	0	0	0	0	0	0	0	0	0	0	0	0	0	0
Marina Noble	Ole Miss	Nov. 11, 2016	Army	0	0	0	0	0	0	0	0	0	0	0	0	0	0	0	0
Samantha Sandifer	Ole Miss	Nov. 11, 2016	Army	0	0	0	0	0	0	0	0	0	0	0	0	0	0	0	0
Kristyn Trump	Ole Miss	Nov. 11, 2016	Army	0	0	0	0	0	0	0	0	0	0	0	0	0	0	0	0
Jillian Tyler	Ole Miss	Nov. 11, 2016	Army	86	88	99	97	93	91	554	18	96	95	97	98	96	95	577	31
Ali Weisz	Ole Miss	Nov. 11, 2016	Army	95	92	98	99	93	95	572	21	97	99	98	99	98	98	589	43
Hayley Carroll	Ole Miss	Nov. 12, 2016	Army	92	95	99	100	88	98	572	27	100	99	97	97	94	100	587	43
Harley Gardner	Ole Miss	Nov. 12, 2016	Army	93	90	98	98	95	93	567	25	95	97	99	99	98	97	585	36
Jess Haig	Ole Miss	Nov. 12, 2016	Army	93	95	98	100	93	97	576	22	97	97	98	100	98	99	589	46
Alana Kelly	Ole Miss	Nov. 12, 2016	Army	97	94	98	98	89	88	564	18	98	95	95	100	98	96	582	34
Randi Loudin	Ole Miss	Nov. 12, 2016	Army	0	0	0	0	0	0	0	0	0	0	0	0	0	0	0	0
Marina Noble	Ole Miss	Nov. 12, 2016	Army	0	0	0	0	0	0	0	0	0	0	0	0	0	0	0	0
Samantha Sandifer	Ole Miss	Nov. 12, 2016	Army	0	0	0	0	0	0	0	0	0	0	0	0	0	0	0	0
Kristyn Trump	Ole Miss	Nov. 12, 2016	Army	0	0	0	0	0	0	0	0	0	0	0	0	0	0	0	0
Jillian Tyler	Ole Miss	Nov. 12, 2016	Army	90	89	98	99	89	90	555	16	97	96	97	97	96	97	580	27
Ali Weisz	Ole Miss	Nov. 12, 2016	Army	96	97	98	96	91	97	575	27	98	98	100	100	99	98	593	47
Jack Anderson	West Virginia	Nov. 12, 2016	Army	95	96	96	98	91	94	570	17	95	98	94	96	98	96	577	26
Will Anti	West Virginia	Nov. 12, 2016	Army	98	94	97	99	93	98	579	27	96	98	96	98	97	98	583	35
Milica Babic	West Virginia	Nov. 12, 2016	Army	97	97	95	98	98	97	582	29	98	100	99	98	99	100	594	48
Noah Barker	West Virginia	Nov. 12, 2016	Army	0	0	0	0	0	0	0	0	0	0	0	0	0	0	0	0
Elizabeth Gratz	West Virginia	Nov. 12, 2016	Army	96	94	97	98	93	96	574	28	100	100	99	100	100	93	592	47
Jean-Pierre Lucas	West Virginia	Nov. 12, 2016	Army	99	98	98	100	95	97	587	36	100	100	98	99	98	100	595	50
Morgan Phillips	West Virginia	Nov. 12, 2016	Army	95	98	98	100	96	98	585	29	98	100	98	98	100	96	590	40
Ginny Thrasher	West Virginia	Nov. 12, 2016	Army	0	0	0	0	0	0	0	0	0	0	0	0	0	0	0	0
Katie Brown	Nebraska	Nov. 12, 2016	Nebraska	91	90	95	98	88	92	554	0	98	93	95	93	95	92	566	0
Jaycee Carter	Nebraska	Nov. 12, 2016	Nebraska	95	92	97	100	94	94	572	0	98	100	99	100	99	97	593	0
Dacotah Faught	Nebraska	Nov. 12, 2016	Nebraska	91	88	98	98	94	96	565	0	98	98	100	100	98	99	593	0
Kayla Gadeken	Nebraska	Nov. 12, 2016	Nebraska	90	93	99	97	96	95	570	0	99	98	97	96	98	98	586	0
Maddie Korthas	Nebraska	Nov. 12, 2016	Nebraska	89	93	92	93	90	94	551	0	97	95	98	97	96	98	581	0
Rachel Martin	Nebraska	Nov. 12, 2016	Nebraska	95	96	99	100	92	94	576	0	97	97	98	98	100	96	586	0
Jordan Miller	Nebraska	Nov. 12, 2016	Nebraska	0	0	0	0	0	0	0	0	0	0	0	0	0	0	0	0
Samantha Peterson	Nebraska	Nov. 12, 2016	Nebraska	95	96	98	100	92	94	575	0	99	99	99	100	98	97	592	0
Nina Radulovic	Nebraska	Nov. 12, 2016	Nebraska	98	94	100	100	89	96	577	0	99	98	98	97	98	99	589	0
Sarah Sutton	Nebraska	Nov. 12, 2016	Nebraska	96	90	99	94	87	90	556	0	95	99	99	97	99	96	585	0
Hannah Virga	Nebraska	Nov. 12, 2016	Nebraska	0	0	0	0	0	0	0	0	0	0	0	0	0	0	0	0
Rachel Yager	Nebraska	Nov. 12, 2016	Nebraska	93	93	99	99	92	93	569	0	97	95	96	97	98	99	582	0
Jessica Kinder	UTEP	Nov. 12, 2016	Nebraska	0	0	0	0	0	0	0	0	0	0	0	0	0	0	0	0
Abby Monique	UTEP	Nov. 12, 2016	Nebraska	88	93	96	97	88	80	542	0	93	97	95	99	95	95	574	0
Maranda Nelson	UTEP	Nov. 12, 2016	Nebraska	0	0	0	0	0	0	0	0	0	0	0	0	0	0	0	0
Bailey Powell	UTEP	Nov. 12, 2016	Nebraska	94	94	98	98	87	92	563	0	98	98	97	98	100	100	591	0
Mara Rouse	UTEP	Nov. 12, 2016	Nebraska	97	94	96	96	92	91	566	0	94	97	93	98	94	98	574	0
Rachael Schoenrock	UTEP	Nov. 12, 2016	Nebraska	95	96	97	94	92	95	569	0	95	97	97	96	95	95	575	0
Haylee Schoenrock	UTEP	Nov. 12, 2016	Nebraska	90	90	95	96	94	91	556	0	98	98	98	97	98	95	584	0
Monthserrat Serna	UTEP	Nov. 12, 2016	Nebraska	0	0	0	0	0	0	0	0	0	0	0	0	0	0	0	0
Spencer Brandon	Air Force	Nov. 12, 2016	TCU	94	93	99	97	89	97	569	0	95	98	98	99	99	95	584	0
Spencer Cap	Air Force	Nov. 12, 2016	TCU	98	98	97	99	96	97	585	0	99	100	98	99	100	98	594	0
Kyle Cox	Air Force	Nov. 12, 2016	TCU	0	0	0	0	0	0	0	0	95	87	95	95	91	97	560	0
Ryan Jacobs	Air Force	Nov. 12, 2016	TCU	96	96	99	98	95	95	579	0	99	98	99	100	99	98	593	0
Noah Kwock	Air Force	Nov. 12, 2016	TCU	0	0	0	0	0	0	0	0	0	0	0	0	0	0	0	0
Nick Learn	Air Force	Nov. 12, 2016	TCU	95	93	97	99	90	87	561	0	97	93	94	97	96	96	573	0
Logan Ogden	Air Force	Nov. 12, 2016	TCU	95	98	98	98	93	93	575	0	100	99	98	100	98	99	594	0
Mary Simonton	Air Force	Nov. 12, 2016	TCU	0	0	0	0	0	0	0	0	0	0	0	0	0	0	0	0
Anna Weilbacher	Air Force	Nov. 12, 2016	TCU	97	97	97	98	92	99	580	0	99	98	96	96	97	96	582	0
Nicholle Benedict	TCU	Nov. 12, 2016	TCU	0	0	0	0	0	0	0	0	0	0	0	0	0	0	0	0
Katie Bridges	TCU	Nov. 12, 2016	TCU	93	95	100	99	88	93	568	0	98	95	94	95	96	95	573	0
Rachel Garner	TCU	Nov. 12, 2016	TCU	96	96	99	100	95	94	580	0	100	100	98	100	99	99	596	0
Ariana Grabowski	TCU	Nov. 12, 2016	TCU	99	97	100	99	95	95	585	0	98	95	99	96	97	97	582	0
Emily Haag	TCU	Nov. 12, 2016	TCU	92	91	98	99	90	92	562	0	98	96	97	93	98	97	579	0
Nicole Hankey	TCU	Nov. 12, 2016	TCU	97	98	100	98	92	95	580	0	96	98	98	97	95	98	582	0
Rachel Kimbell	TCU	Nov. 12, 2016	TCU	98	98	98	96	92	85	567	0	95	95	98	97	95	100	580	0
Sally Li	TCU	Nov. 12, 2016	TCU	96	98	100	99	92	97	582	0	100	100	97	96	98	99	590	0
Casey Lutz	TCU	Nov. 12, 2016	TCU	96	98	100	99	99	95	587	0	97	99	98	99	99	98	590	0
Mindy Miles	TCU	Nov. 12, 2016	TCU	97	97	100	100	96	97	587	0	99	99	99	100	99	99	595	0
Catherine Miller	TCU	Nov. 12, 2016	TCU	96	92	97	100	94	88	567	0	99	98	98	98	98	99	590	0
Meraleigh Randle	TCU	Nov. 12, 2016	TCU	0	0	0	0	0	0	0	0	93	95	93	90	93	89	553	0
Barrett Ray	TCU	Nov. 12, 2016	TCU	99	97	99	99	90	94	578	0	97	98	96	96	95	97	579	0
William Caruso	MIT	Nov. 12, 2016	MIT	87	86	84	76	85	83	501	0	91	87	87	84	89	90	528	0
Efraim Helman	MIT	Nov. 12, 2016	MIT	0	0	0	0	0	0	0	0	0	0	0	0	0	0	0	0
Yaakov Helman	MIT	Nov. 12, 2016	MIT	0	0	0	0	0	0	0	0	0	0	0	0	0	0	0	0
Jesus Herrera	MIT	Nov. 12, 2016	MIT	86	81	94	95	75	67	498	0	85	81	82	81	81	82	492	0
Alexander Laiman	MIT	Nov. 12, 2016	MIT	0	0	0	0	0	0	0	0	0	0	0	0	0	0	0	0
Gregory Lee	MIT	Nov. 12, 2016	MIT	0	0	0	0	0	0	0	0	0	0	0	0	0	0	0	0
Kelly Mathesius	MIT	Nov. 12, 2016	MIT	86	92	97	97	88	90	550	0	89	93	92	86	93	96	549	0
Elijah Miller	MIT	Nov. 12, 2016	MIT	68	77	89	81	65	70	450	0	87	79	78	81	85	87	497	0
Dylan Modesitt	MIT	Nov. 12, 2016	MIT	88	84	91	97	80	71	511	0	90	88	88	85	92	90	533	0
Kevin Ng	MIT	Nov. 12, 2016	MIT	87	89	94	94	82	72	518	0	85	93	91	89	86	89	533	0
Alex Pacheco	MIT	Nov. 12, 2016	MIT	77	79	92	92	60	47	447	0	89	74	77	91	83	82	496	0
Kevin Petrovic	MIT	Nov. 12, 2016	MIT	0	0	0	0	0	0	0	0	0	0	0	0	0	0	0	0
Thomas Rick	MIT	Nov. 12, 2016	MIT	87	73	81	89	72	74	476	0	84	88	85	88	89	78	512	0
Joel Solis	MIT	Nov. 12, 2016	MIT	79	77	82	86	63	72	459	0	82	91	87	88	87	89	524	0
Rachel Hubal	USciences	Nov. 12, 2016	MIT	88	84	94	90	81	86	523	0	87	78	84	85	87	80	501	0
Angela Kang	USciences	Nov. 12, 2016	MIT	79	87	90	88	83	80	507	0	91	89	88	79	79	86	512	0
Brittany Mahoney	USciences	Nov. 12, 2016	MIT	0	0	0	0	0	0	0	0	0	0	0	0	0	0	0	0
Chris Makosiej	USciences	Nov. 12, 2016	MIT	69	67	83	81	57	55	412	0	84	72	86	85	88	84	499	0
Nick Makosiej	USciences	Nov. 12, 2016	MIT	0	0	0	0	0	0	0	0	0	0	0	0	0	0	0	0
Thomas Nelligan	USciences	Nov. 12, 2016	MIT	0	0	0	0	0	0	0	0	0	0	0	0	0	0	0	0
Matt Popowicz	USciences	Nov. 12, 2016	MIT	87	82	92	91	79	75	506	0	88	85	75	80	93	85	506	0
Andrej Quatrone	USciences	Nov. 12, 2016	MIT	85	84	90	85	67	70	481	0	85	79	82	86	76	88	496	0
Sarah Schnupp	USciences	Nov. 12, 2016	MIT	95	95	95	99	93	92	569	0	96	97	90	93	93	95	564	0
Lauren Stabler	USciences	Nov. 12, 2016	MIT	83	83	90	89	77	70	492	0	86	83	89	88	89	89	524	0
Christina Tipton	USciences	Nov. 12, 2016	MIT	0	0	0	0	0	0	0	0	0	0	0	0	0	0	0	0
Allie Tuman	USciences	Nov. 12, 2016	MIT	80	83	91	89	76	82	501	0	84	86	88	84	90	86	518	0
Anita Varkey	USciences	Nov. 12, 2016	MIT	0	0	0	0	0	0	0	0	0	0	0	0	0	0	0	0
Andrew Visconti	USciences	Nov. 12, 2016	MIT	94	89	98	94	91	89	555	0	92	95	90	93	93	84	547	0
Nick Zsoldos	USciences	Nov. 12, 2016	MIT	91	92	92	88	85	83	531	0	87	88	89	89	83	92	528	0
Bobby Broadstreet	Murray St.	Nov. 12, 2016	Ohio State	96	98	100	98	94	96	582	0	100	96	97	97	98	99	587	0
Meike Drewell	Murray St.	Nov. 12, 2016	Ohio State	98	95	99	98	94	90	574	0	0	0	0	0	0	0	0	0
Ben Estes	Murray St.	Nov. 12, 2016	Ohio State	95	95	100	99	96	95	580	0	100	100	100	99	99	98	596	0
Shelby Huber	Murray St.	Nov. 12, 2016	Ohio State	0	0	0	0	0	0	0	0	0	0	0	0	0	0	0	0
Mackenzie Martin	Murray St.	Nov. 12, 2016	Ohio State	95	98	99	99	97	96	584	0	99	99	100	100	97	100	595	0
Ivan Roe	Murray St.	Nov. 12, 2016	Ohio State	97	99	97	97	95	96	581	0	100	98	100	100	99	97	594	0
Barbara Schlapfer	Murray St.	Nov. 12, 2016	Ohio State	98	100	98	98	96	97	587	0	96	97	98	96	100	98	585	0
Alathea Sellars	Murray St.	Nov. 12, 2016	Ohio State	0	0	0	0	0	0	0	0	98	100	100	99	98	99	594	0
Eric Sloan	Murray St.	Nov. 12, 2016	Ohio State	0	0	0	0	0	0	0	0	0	0	0	0	0	0	0	0
Zach Eisenberg	North Carolina St.	Nov. 12, 2016	Ohio State	91	93	97	98	92	91	562	0	99	95	97	97	98	96	582	0
Caitlyn Ford	North Carolina St.	Nov. 12, 2016	Ohio State	90	93	95	96	92	95	561	0	95	97	95	99	99	98	583	0
Sarah Hickey	North Carolina St.	Nov. 12, 2016	Ohio State	0	0	0	0	0	0	0	0	0	0	0	0	0	0	0	0
Lucas Kozeniesky	North Carolina St.	Nov. 12, 2016	Ohio State	97	97	98	97	95	94	578	0	100	100	100	100	100	99	599	0
Tyler Lefebvre	North Carolina St.	Nov. 12, 2016	Ohio State	81	86	96	96	88	92	539	0	96	93	98	96	97	94	574	0
Will Marciniak	North Carolina St.	Nov. 12, 2016	Ohio State	93	95	99	98	91	93	569	0	95	97	97	96	98	97	580	0
Derya Pekari	North Carolina St.	Nov. 12, 2016	Ohio State	96	97	98	98	90	88	567	0	95	98	97	95	96	97	578	0
Lauren Phillips	North Carolina St.	Nov. 12, 2016	Ohio State	93	93	99	98	95	96	574	0	100	98	98	98	99	100	593	0
Claire Spina	North Carolina St.	Nov. 12, 2016	Ohio State	0	0	0	0	0	0	0	0	0	0	0	0	0	0	0	0
Cullen Wargo	North Carolina St.	Nov. 12, 2016	Ohio State	0	0	0	0	0	0	0	0	0	0	0	0	0	0	0	0
George Williams	North Carolina St.	Nov. 12, 2016	Ohio State	0	0	0	0	0	0	0	0	0	0	0	0	0	0	0	0
Claire Zanti	North Carolina St.	Nov. 12, 2016	Ohio State	0	0	0	0	0	0	0	0	0	0	0	0	0	0	0	0
Rachel Benesh	Nevada	Nov. 12, 2016	Ohio State	94	94	97	97	95	91	568	0	99	97	100	98	98	95	587	0
Emily Capaul	Nevada	Nov. 12, 2016	Ohio State	94	96	98	98	93	92	571	0	99	99	98	94	99	100	589	0
Jared Crews	Nevada	Nov. 12, 2016	Ohio State	0	0	0	0	0	0	0	0	0	0	0	0	0	0	0	0
Maneva Gill	Nevada	Nov. 12, 2016	Ohio State	0	0	0	0	0	0	0	0	0	0	0	0	0	0	0	0
Sarah Jameson	Nevada	Nov. 12, 2016	Ohio State	95	95	98	96	93	97	574	0	100	99	98	99	98	99	593	0
Eli Larimer	Nevada	Nov. 12, 2016	Ohio State	93	96	97	98	93	96	573	0	96	95	98	97	96	96	578	0
Justin Nissen	Nevada	Nov. 12, 2016	Ohio State	93	93	97	99	91	90	563	0	98	98	98	96	97	98	585	0
Jami Sexton	Nevada	Nov. 12, 2016	Ohio State	0	0	0	0	0	0	0	0	0	0	0	0	0	0	0	0
Sara Tashima	Nevada	Nov. 12, 2016	Ohio State	0	0	0	0	0	0	0	0	0	0	0	0	0	0	0	0
Mitchell Van Patten	Nevada	Nov. 12, 2016	Ohio State	96	98	99	99	98	98	588	0	99	100	99	98	98	100	594	0
Deanna Binnie	Ohio State	Nov. 12, 2016	Ohio State	99	99	100	100	89	88	575	0	95	96	95	97	97	97	577	0
Josh Black	Ohio State	Nov. 12, 2016	Ohio State	91	92	96	99	95	91	564	0	98	98	100	100	99	97	592	0
Jacob Buchanan	Ohio State	Nov. 12, 2016	Ohio State	96	96	98	95	94	95	574	0	97	97	100	99	100	99	592	0
Drew Cheezum	Ohio State	Nov. 12, 2016	Ohio State	97	96	98	96	98	97	582	0	99	99	100	99	99	99	595	0
Anthony Cuozzo	Ohio State	Nov. 12, 2016	Ohio State	97	97	97	100	94	93	578	0	99	99	98	99	98	97	590	0
Kendal Elder	Ohio State	Nov. 12, 2016	Ohio State	97	93	100	97	91	90	568	0	97	94	95	94	99	97	576	0
Alli Kissell	Ohio State	Nov. 12, 2016	Ohio State	97	96	98	97	94	96	578	0	98	95	96	96	99	97	581	0
Mark Matheny	Ohio State	Nov. 12, 2016	Ohio State	95	95	100	98	92	97	577	0	96	99	100	96	99	99	589	0
Patrick Sardo	Ohio State	Nov. 12, 2016	Ohio State	92	91	97	93	84	84	541	0	92	90	94	94	94	93	557	0
Michael Steinel	Ohio State	Nov. 12, 2016	Ohio State	99	95	97	99	94	93	577	0	100	97	99	98	100	99	593	0
Chrissy Thomas	Ohio State	Nov. 12, 2016	Ohio State	89	88	96	97	92	93	555	0	98	99	96	98	96	97	584	0
Rhiann Travis	Ohio State	Nov. 12, 2016	Ohio State	95	95	94	98	92	95	569	0	99	98	99	99	99	99	593	0
Bailey Urbach	Ohio State	Nov. 12, 2016	Ohio State	97	97	96	100	90	81	561	0	96	97	99	98	94	97	581	0
Brendan Whitaker	Ohio State	Nov. 12, 2016	Ohio State	96	98	98	99	89	90	570	0	97	95	95	93	95	95	570	0
Quintin Wotring	Ohio State	Nov. 12, 2016	Ohio State	95	95	99	99	92	92	572	0	94	99	97	97	97	93	577	0
Jack Berhorst	Memphis	Nov. 12, 2016	Ohio State	94	93	98	99	91	90	565	0	93	100	99	94	93	95	574	0
Haylea Broughton	Memphis	Nov. 12, 2016	Ohio State	95	96	99	97	92	93	572	0	97	96	98	99	98	98	586	0
Levi Clark	Memphis	Nov. 12, 2016	Ohio State	97	96	98	98	90	93	572	0	98	95	98	96	98	99	584	0
Leighton Dempster	Memphis	Nov. 12, 2016	Ohio State	94	91	97	98	91	92	563	0	97	97	98	99	99	97	587	0
Makennon Doran	Memphis	Nov. 12, 2016	Ohio State	0	0	0	0	0	0	0	0	0	0	0	0	0	0	0	0
Amberlie Ezell	Memphis	Nov. 12, 2016	Ohio State	93	97	97	98	93	91	569	0	94	98	96	95	98	96	577	0
Amy Fister	Memphis	Nov. 12, 2016	Ohio State	96	95	100	100	96	96	583	0	96	99	95	99	99	95	583	0
Eli Rischling	Memphis	Nov. 12, 2016	Ohio State	92	95	100	98	91	92	568	0	98	96	94	96	96	94	574	0
Abby Votava	Memphis	Nov. 12, 2016	Ohio State	0	0	0	0	0	0	0	0	0	0	0	0	0	0	0	0
Seth Baker	Morehead St.	Nov. 12, 2016	VMI	93	96	97	97	90	94	567	0	92	98	99	95	98	97	579	0
Brandon Bryer	Morehead St.	Nov. 12, 2016	VMI	98	96	97	100	91	93	575	0	95	96	98	92	98	94	573	0
Siarra Crum	Morehead St.	Nov. 12, 2016	VMI	85	85	96	93	91	91	541	0	98	97	96	97	97	99	584	0
Sarah Fink	Morehead St.	Nov. 12, 2016	VMI	97	94	97	98	94	91	571	0	94	95	97	98	95	94	573	0
Joe Fischer	Morehead St.	Nov. 12, 2016	VMI	94	97	99	100	89	89	568	0	97	97	98	97	97	94	580	0
Dan Hall	Morehead St.	Nov. 12, 2016	VMI	95	94	99	98	87	91	564	0	91	91	96	96	96	98	568	0
Jesse Moyer	Morehead St.	Nov. 12, 2016	VMI	0	0	0	0	0	0	0	0	0	0	0	0	0	0	0	0
Alexa Potts	Morehead St.	Nov. 12, 2016	VMI	97	95	95	96	90	96	569	0	97	95	96	97	95	97	577	0
Karly Potts	Morehead St.	Nov. 12, 2016	VMI	94	94	95	96	89	91	559	0	96	99	99	95	98	97	584	0
Melanie West	Morehead St.	Nov. 12, 2016	VMI	96	92	98	96	85	80	547	0	97	91	96	95	97	96	572	0
Haley Wilson	Morehead St.	Nov. 12, 2016	VMI	0	0	0	0	0	0	0	0	0	0	0	0	0	0	0	0
Andrew Abernathy	North Georgia	Nov. 12, 2016	VMI	91	97	97	96	91	87	559	0	95	94	94	97	94	97	571	0
Eric Azotea	North Georgia	Nov. 12, 2016	VMI	0	0	0	0	0	0	0	0	0	0	0	0	0	0	0	0
Ruthanne Conner	North Georgia	Nov. 12, 2016	VMI	97	94	98	98	93	94	574	0	91	89	94	97	95	95	561	0
Lucas Gilliland	North Georgia	Nov. 12, 2016	VMI	0	0	0	0	0	0	0	0	0	0	0	0	0	0	0	0
Maddie Godwin	North Georgia	Nov. 12, 2016	VMI	0	0	0	0	0	0	0	0	0	0	0	0	0	0	0	0
Hannah Peevy	North Georgia	Nov. 12, 2016	VMI	0	0	0	0	0	0	0	0	0	0	0	0	0	0	0	0
Jared Rice	North Georgia	Nov. 12, 2016	VMI	97	91	95	96	94	90	563	0	95	96	93	97	99	97	577	0
Tobin Sanctuary	North Georgia	Nov. 12, 2016	VMI	93	93	99	100	95	94	574	0	0	0	0	0	0	0	0	0
Brianna Shaw	North Georgia	Nov. 12, 2016	VMI	0	0	0	0	0	0	0	0	0	0	0	0	0	0	0	0
Dakota Spivey	North Georgia	Nov. 12, 2016	VMI	95	96	95	97	89	96	568	0	97	95	100	99	98	98	587	0
David Turner	North Georgia	Nov. 12, 2016	VMI	0	0	0	0	0	0	0	0	97	97	93	93	94	93	567	0
Kealie Engels	Wofford	Nov. 12, 2016	VMI	0	0	0	0	0	0	0	0	0	0	0	0	0	0	0	0
Seth Flanagan	Wofford	Nov. 12, 2016	VMI	84	85	92	92	88	90	531	0	91	91	90	93	90	93	548	0
Cierra Holcombe	Wofford	Nov. 12, 2016	VMI	94	98	92	97	85	85	551	0	97	93	95	96	94	93	568	0
Carson Howell	Wofford	Nov. 12, 2016	VMI	0	0	0	0	0	0	0	0	0	0	0	0	0	0	0	0
Nicholas Hunter	Wofford	Nov. 12, 2016	VMI	82	91	91	94	83	80	521	0	93	91	91	95	91	90	551	0
Zachry Hunter	Wofford	Nov. 12, 2016	VMI	0	0	0	0	0	0	0	0	84	81	84	88	89	86	512	0
Reid Schuster	Wofford	Nov. 12, 2016	VMI	86	77	88	92	74	69	486	0	84	77	82	86	87	86	502	0
William Davidson	VMI	Nov. 12, 2016	VMI	88	85	96	96	85	87	537	0	92	96	99	98	90	96	571	0
Andrew Hickey	VMI	Nov. 12, 2016	VMI	94	94	97	96	94	89	564	0	93	95	96	96	95	94	569	0
Jacob Hunter	VMI	Nov. 12, 2016	VMI	0	0	0	0	0	0	0	0	98	96	98	95	98	96	581	0
Zachary Johnson	VMI	Nov. 12, 2016	VMI	94	91	97	98	86	88	554	0	0	0	0	0	0	0	0	0
Mathew Lusardi	VMI	Nov. 12, 2016	VMI	86	85	98	95	93	80	537	0	94	94	96	97	97	93	571	0
Chris Milliken	VMI	Nov. 12, 2016	VMI	0	0	0	0	0	0	0	0	89	96	96	96	95	92	564	0
John Pitman	VMI	Nov. 12, 2016	VMI	89	94	96	97	90	86	552	0	0	0	0	0	0	0	0	0
Nick Reynolds	VMI	Nov. 12, 2016	VMI	86	90	97	98	85	83	539	0	93	92	96	95	95	98	569	0
Kelia Aardema	VMI (W)	Nov. 12, 2016	VMI	0	0	0	0	0	0	0	0	0	0	0	0	0	0	0	0
Samantha Alexander	VMI (W)	Nov. 12, 2016	VMI	85	92	97	93	92	91	550	0	90	94	96	94	99	97	570	0
Ellana Avery	VMI (W)	Nov. 12, 2016	VMI	0	0	0	0	0	0	0	0	0	0	0	0	0	0	0	0
Sabrina Bell	VMI (W)	Nov. 12, 2016	VMI	0	0	0	0	0	0	0	0	0	0	0	0	0	0	0	0
Alice Chiu	VMI (W)	Nov. 12, 2016	VMI	87	88	95	100	87	87	544	0	92	94	94	95	96	98	569	0
Jamie Foster	VMI (W)	Nov. 12, 2016	VMI	0	0	0	0	0	0	0	0	0	0	0	0	0	0	0	0
Joelle Henry	VMI (W)	Nov. 12, 2016	VMI	0	0	0	0	0	0	0	0	0	0	0	0	0	0	0	0
Rachel Jankelow	VMI (W)	Nov. 12, 2016	VMI	90	87	93	93	85	86	534	0	93	94	92	91	95	95	560	0
Kerrie Lightfoot	VMI (W)	Nov. 12, 2016	VMI	0	0	0	0	0	0	0	0	95	94	93	91	90	92	555	0
Loyce Lightfoot	VMI (W)	Nov. 12, 2016	VMI	89	91	92	91	91	85	539	0	0	0	0	0	0	0	0	0
Kaitlyn Morrison	VMI (W)	Nov. 12, 2016	VMI	0	0	0	0	0	0	0	0	0	0	0	0	0	0	0	0
Katherine Watson	VMI (W)	Nov. 12, 2016	VMI	91	88	96	94	89	82	540	0	93	94	94	96	91	88	556	0
Melissa Brizzi	Coast Guard	Nov. 12, 2016	Coast Guard	88	82	87	90	75	70	492	0	90	86	89	88	85	87	525	0
Joseph Busching	Coast Guard	Nov. 12, 2016	Coast Guard	0	0	0	0	0	0	0	0	91	90	91	93	87	80	532	0
Jacob Dupree	Coast Guard	Nov. 12, 2016	Coast Guard	88	93	95	95	80	84	535	0	88	92	94	94	92	94	554	0
Randall Ford	Coast Guard	Nov. 12, 2016	Coast Guard	89	90	98	99	87	90	553	0	89	93	94	93	95	97	561	0
Marshall Grant	Coast Guard	Nov. 12, 2016	Coast Guard	79	76	94	95	74	85	503	0	94	90	83	85	92	94	538	0
Alexandria Harrington	Coast Guard	Nov. 12, 2016	Coast Guard	96	90	95	98	94	93	566	0	98	95	93	97	92	94	569	0
Anthony Lee	Coast Guard	Nov. 12, 2016	Coast Guard	0	0	0	0	0	0	0	0	0	0	0	0	0	0	0	0
Dylan Lorence	Coast Guard	Nov. 12, 2016	Coast Guard	89	95	98	98	84	87	551	0	91	90	88	93	97	95	554	0
Kaden Nichols	Coast Guard	Nov. 12, 2016	Coast Guard	0	0	0	0	0	0	0	0	84	88	87	85	86	86	516	0
Nicholas Paisker	Coast Guard	Nov. 12, 2016	Coast Guard	92	89	97	94	89	92	553	0	98	94	98	92	94	98	574	0
Paul Raynolds	Coast Guard	Nov. 12, 2016	Coast Guard	0	0	0	0	0	0	0	0	0	0	0	0	0	0	0	0
David Rose	Coast Guard	Nov. 12, 2016	Coast Guard	80	83	88	88	60	63	462	0	89	85	85	91	90	85	525	0
Alaric Stone	Coast Guard	Nov. 12, 2016	Coast Guard	0	0	0	0	0	0	0	0	93	92	86	90	89	88	538	0
Nyjah Turner	Coast Guard	Nov. 12, 2016	Coast Guard	0	0	0	0	0	0	0	0	92	81	85	94	93	89	534	0
Angelica Dearaujo	John Jay	Nov. 12, 2016	Coast Guard	88	90	95	94	91	90	548	0	93	95	97	99	99	93	576	0
Lily Graham	John Jay	Nov. 12, 2016	Coast Guard	96	96	95	97	89	89	562	0	96	98	99	97	98	97	585	0
Ronald Kopec	John Jay	Nov. 12, 2016	Coast Guard	83	94	95	96	84	76	528	0	96	90	96	97	94	92	565	0
Eliza Kotowska	John Jay	Nov. 12, 2016	Coast Guard	0	0	0	0	0	0	0	0	0	0	0	0	0	0	0	0
Susana Sanchez	John Jay	Nov. 12, 2016	Coast Guard	90	89	82	53	71	82	467	0	87	90	93	92	96	93	551	0
Ida Sato	John Jay	Nov. 12, 2016	Coast Guard	80	83	87	94	74	74	492	0	90	90	93	95	90	92	550	0
Marc Suda	John Jay	Nov. 12, 2016	Coast Guard	81	78	97	98	87	85	526	0	92	88	89	88	92	89	538	0
Allison Auten	Citadel	Nov. 12, 2016	Citadel	89	86	93	95	87	92	542	0	95	96	97	97	100	94	579	0
Matthew Davenport	Citadel	Nov. 12, 2016	Citadel	85	93	94	89	85	83	529	0	93	92	85	94	93	87	544	0
Joseph Ferguson	Citadel	Nov. 12, 2016	Citadel	86	88	95	93	79	83	524	0	92	94	92	95	92	93	558	0
Morgan Long	Citadel	Nov. 12, 2016	Citadel	0	0	0	0	0	0	0	0	0	0	0	0	0	0	0	0
Alexander McAlear	Citadel	Nov. 12, 2016	Citadel	92	91	98	95	87	92	555	0	96	91	94	97	97	96	571	0
Patrick Meyer	Citadel	Nov. 12, 2016	Citadel	94	91	96	93	86	81	541	0	93	94	96	91	90	96	560	0
Richie Parra	Citadel	Nov. 12, 2016	Citadel	90	91	96	93	87	85	542	0	92	95	97	95	92	93	564	0
Colton Poole	Citadel	Nov. 12, 2016	Citadel	96	95	97	97	92	89	566	0	96	95	97	94	96	96	574	0
Tommy Simrill	Citadel	Nov. 12, 2016	Citadel	87	92	94	97	81	52	503	0	92	88	89	95	90	97	551	0
Carli Cline	Citadel (W)	Nov. 12, 2016	Citadel	89	87	92	96	73	77	514	0	88	91	90	86	91	88	534	0
Brandi Duzz	Citadel (W)	Nov. 12, 2016	Citadel	86	83	95	94	74	75	507	0	95	96	97	90	94	89	561	0
Leah Fenwrick-Wallace	Citadel (W)	Nov. 12, 2016	Citadel	84	92	93	88	84	83	524	0	95	93	96	91	94	91	560	0
Shadonna Littlejohn	Citadel (W)	Nov. 12, 2016	Citadel	87	92	90	90	77	82	518	0	90	92	93	94	95	86	550	0
Tierra Price	Citadel (W)	Nov. 12, 2016	Citadel	75	75	89	88	72	59	458	0	85	89	88	85	81	87	515	0
Faith Totherow	Citadel (W)	Nov. 12, 2016	Citadel	93	93	94	94	91	89	554	0	91	94	92	93	95	90	555	0
Raven Wills	Citadel (W)	Nov. 12, 2016	Citadel	87	86	90	90	82	89	524	0	92	91	89	87	88	94	541	0
William Caruso	MIT	Nov. 13, 2016	MIT	90	85	85	72	83	75	490	0	82	86	81	87	90	77	503	0
Efraim Helman	MIT	Nov. 13, 2016	MIT	0	0	0	0	0	0	0	0	75	73	69	82	84	77	460	5
Yaakov Helman	MIT	Nov. 13, 2016	MIT	0	0	0	0	0	0	0	0	78	81	74	75	72	82	462	5
Jesus Herrera	MIT	Nov. 13, 2016	MIT	92	94	92	92	71	74	515	0	74	82	80	88	90	84	498	0
Alexander Laiman	MIT	Nov. 13, 2016	MIT	0	0	0	0	0	0	0	0	0	0	0	0	0	0	0	0
Gregory Lee	MIT	Nov. 13, 2016	MIT	0	0	0	0	0	0	0	0	0	0	0	0	0	0	0	0
Kelly Mathesius	MIT	Nov. 13, 2016	MIT	91	89	93	93	88	82	536	0	94	97	89	98	94	94	566	0
Elijah Miller	MIT	Nov. 13, 2016	MIT	74	83	77	83	58	72	447	0	85	77	80	78	83	77	480	3
Dylan Modesitt	MIT	Nov. 13, 2016	MIT	88	91	94	99	74	87	533	0	88	93	86	86	93	84	530	0
Kevin Ng	MIT	Nov. 13, 2016	MIT	89	92	96	95	78	85	535	0	90	92	87	87	86	90	532	0
Alex Pacheco	MIT	Nov. 13, 2016	MIT	0	0	0	0	0	0	0	0	82	82	79	78	85	90	496	4
Kevin Petrovic	MIT	Nov. 13, 2016	MIT	0	0	0	0	0	0	0	0	0	0	0	0	0	0	0	0
Thomas Rick	MIT	Nov. 13, 2016	MIT	0	0	0	0	0	0	0	0	0	0	0	0	0	0	0	0
Joel Solis	MIT	Nov. 13, 2016	MIT	77	66	86	91	63	56	439	0	84	84	87	91	86	88	520	0
Rachel Hubal	USciences	Nov. 13, 2016	MIT	86	82	90	92	83	85	518	0	83	83	84	86	90	86	512	6
Angela Kang	USciences	Nov. 13, 2016	MIT	89	91	92	95	77	88	532	0	84	87	88	87	89	89	524	0
Brittany Mahoney	USciences	Nov. 13, 2016	MIT	0	0	0	0	0	0	0	0	0	0	0	0	0	0	0	0
Chris Makosiej	USciences	Nov. 13, 2016	MIT	85	89	81	75	75	56	461	0	73	85	77	79	82	91	487	7
Nick Makosiej	USciences	Nov. 13, 2016	MIT	0	0	0	0	0	0	0	0	0	0	0	0	0	0	0	0
Thomas Nelligan	USciences	Nov. 13, 2016	MIT	0	0	0	0	0	0	0	0	0	0	0	0	0	0	0	0
Matt Popowicz	USciences	Nov. 13, 2016	MIT	84	85	96	89	85	75	514	0	87	88	85	85	87	87	519	0
Andrej Quatrone	USciences	Nov. 13, 2016	MIT	89	94	80	86	64	69	482	0	81	91	82	80	76	89	499	5
Sarah Schnupp	USciences	Nov. 13, 2016	MIT	92	98	96	96	94	90	566	0	99	94	97	94	95	93	572	0
Lauren Stabler	USciences	Nov. 13, 2016	MIT	80	91	85	86	73	78	493	0	86	90	91	86	88	91	532	13
Christina Tipton	USciences	Nov. 13, 2016	MIT	0	0	0	0	0	0	0	0	0	0	0	0	0	0	0	0
Allie Tuman	USciences	Nov. 13, 2016	MIT	93	81	93	91	72	79	509	0	84	93	88	86	85	88	524	0
Anita Varkey	USciences	Nov. 13, 2016	MIT	0	0	0	0	0	0	0	0	0	0	0	0	0	0	0	0
Andrew Visconti	USciences	Nov. 13, 2016	MIT	93	92	95	95	87	88	550	0	87	89	91	90	91	88	536	0
Nick Zsoldos	USciences	Nov. 13, 2016	MIT	85	86	88	91	83	91	524	0	89	79	84	91	84	91	518	0
Spencer Brandon	Air Force	Nov. 13, 2016	TCU	96	96	99	99	89	89	568	0	95	98	95	100	99	98	585	0
Spencer Cap	Air Force	Nov. 13, 2016	TCU	98	96	99	99	96	94	582	0	100	98	100	99	97	99	593	0
Kyle Cox	Air Force	Nov. 13, 2016	TCU	0	0	0	0	0	0	0	0	93	94	95	93	94	98	567	0
Ryan Jacobs	Air Force	Nov. 13, 2016	TCU	99	94	99	99	93	96	580	0	99	98	99	99	100	97	592	0
Noah Kwock	Air Force	Nov. 13, 2016	TCU	0	0	0	0	0	0	0	0	0	0	0	0	0	0	0	0
Nick Learn	Air Force	Nov. 13, 2016	TCU	96	95	96	100	91	92	570	0	99	99	97	98	96	98	587	0
Logan Ogden	Air Force	Nov. 13, 2016	TCU	96	99	99	100	90	92	576	0	100	99	97	99	98	97	590	0
Mary Simonton	Air Force	Nov. 13, 2016	TCU	0	0	0	0	0	0	0	0	0	0	0	0	0	0	0	0
Anna Weilbacher	Air Force	Nov. 13, 2016	TCU	96	95	100	98	93	97	579	0	99	95	97	97	99	100	587	0
Nicholle Benedict	TCU	Nov. 13, 2016	TCU	92	91	94	99	88	85	549	0	97	96	98	95	97	99	582	0
Katie Bridges	TCU	Nov. 13, 2016	TCU	94	97	100	99	83	87	560	0	96	96	95	93	94	93	567	0
Rachel Garner	TCU	Nov. 13, 2016	TCU	98	100	100	99	96	95	588	0	98	98	97	100	98	99	590	0
Ariana Grabowski	TCU	Nov. 13, 2016	TCU	100	99	100	99	95	96	589	0	99	99	95	98	98	98	587	0
Emily Haag	TCU	Nov. 13, 2016	TCU	96	92	99	98	85	90	560	0	93	96	93	98	95	95	570	0
Nicole Hankey	TCU	Nov. 13, 2016	TCU	98	97	97	97	93	95	577	0	99	97	96	99	98	98	587	0
Rachel Kimbell	TCU	Nov. 13, 2016	TCU	97	95	97	99	91	91	570	0	88	98	99	98	97	98	578	0
Sally Li	TCU	Nov. 13, 2016	TCU	96	94	100	98	95	97	580	0	99	99	99	100	100	99	596	0
Casey Lutz	TCU	Nov. 13, 2016	TCU	98	94	99	99	97	98	585	0	99	98	99	100	99	97	592	0
Mindy Miles	TCU	Nov. 13, 2016	TCU	99	100	99	98	97	98	591	0	99	100	100	100	99	99	597	0
Catherine Miller	TCU	Nov. 13, 2016	TCU	95	94	98	100	94	94	575	0	99	97	99	98	98	99	590	0
Meraleigh Randle	TCU	Nov. 13, 2016	TCU	0	0	0	0	0	0	0	0	0	0	0	0	0	0	0	0
Barrett Ray	TCU	Nov. 13, 2016	TCU	96	98	98	98	93	86	569	0	99	98	98	99	97	98	589	0
Katie Brown	Nebraska	Nov. 13, 2016	Nebraska	86	91	97	97	90	87	548	0	97	92	95	94	94	95	567	0
Jaycee Carter	Nebraska	Nov. 13, 2016	Nebraska	92	94	97	97	96	95	571	0	98	100	97	99	99	99	592	0
Dacotah Faught	Nebraska	Nov. 13, 2016	Nebraska	92	93	99	100	96	96	576	0	99	98	96	99	100	97	589	0
Kayla Gadeken	Nebraska	Nov. 13, 2016	Nebraska	96	98	98	97	93	93	575	0	98	100	97	100	98	98	591	0
Maddie Korthas	Nebraska	Nov. 13, 2016	Nebraska	94	95	96	95	92	94	566	0	95	99	95	97	94	99	579	0
Rachel Martin	Nebraska	Nov. 13, 2016	Nebraska	97	99	99	100	95	94	584	32	97	96	100	98	99	97	587	0
Jordan Miller	Nebraska	Nov. 13, 2016	Nebraska	0	0	0	0	0	0	0	0	0	0	0	0	0	0	0	0
Samantha Peterson	Nebraska	Nov. 13, 2016	Nebraska	96	94	97	95	94	92	568	0	98	100	99	97	99	97	590	0
Nina Radulovic	Nebraska	Nov. 13, 2016	Nebraska	93	97	99	99	91	97	576	0	98	99	99	97	98	99	590	0
Sarah Sutton	Nebraska	Nov. 13, 2016	Nebraska	91	90	93	94	89	83	540	0	99	97	96	97	98	98	585	0
Hannah Virga	Nebraska	Nov. 13, 2016	Nebraska	0	0	0	0	0	0	0	0	0	0	0	0	0	0	0	0
Rachel Yager	Nebraska	Nov. 13, 2016	Nebraska	92	93	96	95	91	93	560	0	96	99	97	97	98	97	584	0
Jessica Kinder	UTEP	Nov. 13, 2016	Nebraska	0	0	0	0	0	0	0	0	0	0	0	0	0	0	0	0
Abby Monique	UTEP	Nov. 13, 2016	Nebraska	93	96	98	98	90	92	567	0	100	95	96	93	99	94	577	0
Maranda Nelson	UTEP	Nov. 13, 2016	Nebraska	0	0	0	0	0	0	0	0	0	0	0	0	0	0	0	0
Bailey Powell	UTEP	Nov. 13, 2016	Nebraska	94	92	96	98	89	85	554	0	99	99	100	100	99	100	597	0
Mara Rouse	UTEP	Nov. 13, 2016	Nebraska	94	94	97	97	88	89	559	0	97	96	96	94	92	95	570	0
Rachael Schoenrock	UTEP	Nov. 13, 2016	Nebraska	97	93	97	96	94	95	572	0	99	97	93	97	97	96	579	0
Haylee Schoenrock	UTEP	Nov. 13, 2016	Nebraska	92	92	94	99	88	92	557	0	98	98	98	97	93	96	580	0
Monthserrat Serna	UTEP	Nov. 13, 2016	Nebraska	0	0	0	0	0	0	0	0	0	0	0	0	0	0	0	0
Nathan Brewer	Army	Nov. 13, 2016	Army	96	93	99	97	94	92	571	28	97	98	100	99	98	98	590	43
Emiliano Concha-Toro	Army	Nov. 13, 2016	Army	97	90	100	98	95	93	573	27	97	95	95	95	94	98	574	21
Ethan Cook	Army	Nov. 13, 2016	Army	94	93	97	99	93	94	570	22	96	97	97	96	96	94	576	26
Danielle Cuomo	Army	Nov. 13, 2016	Army	100	98	94	97	92	95	576	29	99	95	100	96	98	97	585	39
Maggie Ehmann	Army	Nov. 13, 2016	Army	93	92	100	94	83	87	549	15	94	95	94	98	98	97	576	29
Maddy Erikson	Army	Nov. 13, 2016	Army	93	94	98	97	93	89	564	21	96	97	97	98	98	99	585	36
Mike Garner	Army	Nov. 13, 2016	Army	95	99	99	98	92	84	567	23	93	95	96	95	95	96	570	23
Nick Kanellis	Army	Nov. 13, 2016	Army	91	87	99	99	94	94	564	24	95	96	97	98	97	96	579	33
Marvin Lewis	Army	Nov. 13, 2016	Army	93	95	99	98	98	96	579	26	97	99	100	99	99	98	592	39
Rhianna Lichtenthal	Army	Nov. 13, 2016	Army	91	88	94	98	92	94	557	18	97	100	96	96	98	98	585	36
Libby Mostert	Army	Nov. 13, 2016	Army	94	94	100	100	90	94	572	30	98	96	93	99	93	99	578	30
Sarah Nakata	Army	Nov. 13, 2016	Army	0	0	0	0	0	0	0	0	96	100	92	99	97	95	579	26
Payne Nunn	Army	Nov. 13, 2016	Army	97	94	100	100	92	94	577	29	98	100	96	99	98	96	587	40
Allen Solida	Army	Nov. 13, 2016	Army	90	92	100	97	91	98	568	22	96	96	97	93	98	95	575	26
Andrew Solomonides	Army	Nov. 13, 2016	Army	97	94	97	98	87	88	561	18	93	96	95	95	97	94	570	25
Jack Anderson	West Virginia	Nov. 13, 2016	Army	95	96	96	94	91	96	568	23	95	96	95	97	98	99	580	33
Will Anti	West Virginia	Nov. 13, 2016	Army	94	95	98	98	91	95	571	21	100	98	98	99	97	96	588	43
Milica Babic	West Virginia	Nov. 13, 2016	Army	96	98	100	98	94	97	583	20	100	99	97	100	99	99	594	46
Noah Barker	West Virginia	Nov. 13, 2016	Army	0	0	0	0	0	0	0	0	0	0	0	0	0	0	0	0
Elizabeth Gratz	West Virginia	Nov. 13, 2016	Army	96	95	99	99	94	97	580	25	98	97	100	100	100	99	594	47
Jean-Pierre Lucas	West Virginia	Nov. 13, 2016	Army	99	98	98	100	93	100	588	24	100	98	99	99	98	98	592	46
Morgan Phillips	West Virginia	Nov. 13, 2016	Army	98	99	100	99	96	95	587	33	99	100	99	99	98	99	594	44
Ginny Thrasher	West Virginia	Nov. 13, 2016	Army	0	0	0	0	0	0	0	0	0	0	0	0	0	0	0	0
Billy Azzinaro	Kentucky	Nov. 18, 2016	Alaska Fairbanks	96	96	98	99	94	97	580	0	99	98	98	98	98	98	589	0
Jenna Bethea	Kentucky	Nov. 18, 2016	Alaska Fairbanks	92	95	98	95	90	92	562	0	97	97	97	98	95	98	582	0
Hanna Carr	Kentucky	Nov. 18, 2016	Alaska Fairbanks	97	99	100	98	95	96	585	0	98	98	98	98	98	100	590	0
Morgan Duerr	Kentucky	Nov. 18, 2016	Alaska Fairbanks	94	92	96	100	91	91	564	0	91	97	97	96	97	99	577	0
Ian Foos	Kentucky	Nov. 18, 2016	Alaska Fairbanks	91	90	97	97	88	94	557	0	98	99	97	98	98	99	589	0
Carmen Fry	Kentucky	Nov. 18, 2016	Alaska Fairbanks	93	87	100	99	95	91	565	0	98	96	94	96	98	95	577	0
Heather Kirby	Kentucky	Nov. 18, 2016	Alaska Fairbanks	94	97	99	98	94	96	578	0	100	99	99	100	99	99	596	0
Sonya May	Kentucky	Nov. 18, 2016	Alaska Fairbanks	95	91	99	99	93	93	570	0	95	96	99	97	98	96	581	0
Andrew Miller	Kentucky	Nov. 18, 2016	Alaska Fairbanks	0	0	0	0	0	0	0	0	0	0	0	0	0	0	0	0
Cathryn Papasodora	Kentucky	Nov. 18, 2016	Alaska Fairbanks	97	93	97	97	94	94	572	0	96	99	99	98	100	97	589	0
Jason Scharbel	Kentucky	Nov. 18, 2016	Alaska Fairbanks	94	96	98	99	92	96	575	0	95	95	96	97	100	98	581	0
Jason Spaude	Kentucky	Nov. 18, 2016	Alaska Fairbanks	99	92	99	99	96	95	580	0	99	98	99	98	98	99	591	0
Zach Eisenberg	North Carolina St.	Nov. 18, 2016	Alaska Fairbanks	0	0	0	0	0	0	0	0	0	0	0	0	0	0	0	0
Caitlyn Ford	North Carolina St.	Nov. 18, 2016	Alaska Fairbanks	99	93	94	92	96	97	571	0	97	98	97	98	97	96	583	0
Sarah Hickey	North Carolina St.	Nov. 18, 2016	Alaska Fairbanks	0	0	0	0	0	0	0	0	0	0	0	0	0	0	0	0
Lucas Kozeniesky	North Carolina St.	Nov. 18, 2016	Alaska Fairbanks	100	97	98	99	97	90	581	0	99	98	99	100	100	99	595	0
Tyler Lefebvre	North Carolina St.	Nov. 18, 2016	Alaska Fairbanks	0	0	0	0	0	0	0	0	0	0	0	0	0	0	0	0
Will Marciniak	North Carolina St.	Nov. 18, 2016	Alaska Fairbanks	97	96	99	97	95	93	577	0	98	96	97	99	93	97	580	0
Derya Pekari	North Carolina St.	Nov. 18, 2016	Alaska Fairbanks	96	93	99	99	87	95	569	0	98	98	93	96	98	98	581	0
Lauren Phillips	North Carolina St.	Nov. 18, 2016	Alaska Fairbanks	95	96	97	97	95	97	577	0	99	100	99	98	98	99	593	0
Claire Spina	North Carolina St.	Nov. 18, 2016	Alaska Fairbanks	0	0	0	0	0	0	0	0	0	0	0	0	0	0	0	0
Cullen Wargo	North Carolina St.	Nov. 18, 2016	Alaska Fairbanks	0	0	0	0	0	0	0	0	0	0	0	0	0	0	0	0
George Williams	North Carolina St.	Nov. 18, 2016	Alaska Fairbanks	0	0	0	0	0	0	0	0	0	0	0	0	0	0	0	0
Claire Zanti	North Carolina St.	Nov. 18, 2016	Alaska Fairbanks	96	94	100	96	91	94	571	0	97	97	97	95	95	97	578	0
Melissa Brizzi	Coast Guard	Nov. 18, 2016	Coast Guard	93	88	94	98	75	83	531	0	92	88	91	93	86	89	539	0
Joseph Busching	Coast Guard	Nov. 18, 2016	Coast Guard	0	0	0	0	0	0	0	0	88	91	91	87	89	91	537	0
Jacob Dupree	Coast Guard	Nov. 18, 2016	Coast Guard	91	94	91	92	79	91	538	0	93	89	91	87	86	92	538	0
Randall Ford	Coast Guard	Nov. 18, 2016	Coast Guard	92	91	94	98	81	83	539	0	96	90	91	89	91	93	550	0
Marshall Grant	Coast Guard	Nov. 18, 2016	Coast Guard	86	88	97	94	77	83	525	0	93	95	92	91	98	94	563	0
Alexandria Harrington	Coast Guard	Nov. 18, 2016	Coast Guard	86	94	95	96	94	94	559	0	93	95	91	96	96	94	565	0
Anthony Lee	Coast Guard	Nov. 18, 2016	Coast Guard	0	0	0	0	0	0	0	0	0	0	0	0	0	0	0	0
Dylan Lorence	Coast Guard	Nov. 18, 2016	Coast Guard	95	94	96	97	84	84	550	0	92	91	89	92	94	95	553	0
Kaden Nichols	Coast Guard	Nov. 18, 2016	Coast Guard	0	0	0	0	0	0	0	0	79	91	90	87	93	88	528	0
Nicholas Paisker	Coast Guard	Nov. 18, 2016	Coast Guard	89	88	99	84	86	90	536	0	98	97	97	97	99	96	584	0
Paul Raynolds	Coast Guard	Nov. 18, 2016	Coast Guard	0	0	0	0	0	0	0	0	0	0	0	0	0	0	0	0
David Rose	Coast Guard	Nov. 18, 2016	Coast Guard	85	84	93	91	82	81	516	0	87	83	90	86	90	85	521	0
Alaric Stone	Coast Guard	Nov. 18, 2016	Coast Guard	0	0	0	0	0	0	0	0	89	91	92	88	80	94	534	0
Nyjah Turner	Coast Guard	Nov. 18, 2016	Coast Guard	94	89	95	94	83	81	536	0	90	94	94	92	93	91	554	0
Rachel Hubal	USciences	Nov. 18, 2016	Coast Guard	84	92	94	98	83	79	530	0	80	87	88	88	88	83	514	0
Angela Kang	USciences	Nov. 18, 2016	Coast Guard	81	83	89	92	86	84	515	0	85	89	92	93	86	90	535	0
Brittany Mahoney	USciences	Nov. 18, 2016	Coast Guard	0	0	0	0	0	0	0	0	0	0	0	0	0	0	0	0
Chris Makosiej	USciences	Nov. 18, 2016	Coast Guard	0	0	0	0	0	0	0	0	0	0	0	0	0	0	0	0
Nick Makosiej	USciences	Nov. 18, 2016	Coast Guard	0	0	0	0	0	0	0	0	0	0	0	0	0	0	0	0
Thomas Nelligan	USciences	Nov. 18, 2016	Coast Guard	0	0	0	0	0	0	0	0	0	0	0	0	0	0	0	0
Matt Popowicz	USciences	Nov. 18, 2016	Coast Guard	85	85	95	96	87	80	528	0	86	88	89	89	84	88	524	0
Andrej Quatrone	USciences	Nov. 18, 2016	Coast Guard	0	0	0	0	0	0	0	0	0	0	0	0	0	0	0	0
Sarah Schnupp	USciences	Nov. 18, 2016	Coast Guard	94	96	97	98	90	95	570	0	94	93	97	97	100	98	579	0
Lauren Stabler	USciences	Nov. 18, 2016	Coast Guard	0	0	0	0	0	0	0	0	0	0	0	0	0	0	0	0
Christina Tipton	USciences	Nov. 18, 2016	Coast Guard	0	0	0	0	0	0	0	0	0	0	0	0	0	0	0	0
Allie Tuman	USciences	Nov. 18, 2016	Coast Guard	0	0	0	0	0	0	0	0	0	0	0	0	0	0	0	0
Anita Varkey	USciences	Nov. 18, 2016	Coast Guard	0	0	0	0	0	0	0	0	0	0	0	0	0	0	0	0
Andrew Visconti	USciences	Nov. 18, 2016	Coast Guard	91	84	95	95	82	85	532	0	90	90	92	91	91	89	543	0
Nick Zsoldos	USciences	Nov. 18, 2016	Coast Guard	91	94	93	91	78	85	532	0	92	85	86	87	93	91	534	0
Melissa Brizzi	Coast Guard	Nov. 18, 2016	Coast Guard	93	88	94	98	75	83	531	0	92	88	91	93	86	89	539	0
Joseph Busching	Coast Guard	Nov. 18, 2016	Coast Guard	0	0	0	0	0	0	0	0	88	91	91	87	89	91	537	0
Jacob Dupree	Coast Guard	Nov. 18, 2016	Coast Guard	91	94	91	92	79	91	538	0	93	89	91	87	86	92	538	0
Randall Ford	Coast Guard	Nov. 18, 2016	Coast Guard	92	91	94	98	81	83	539	0	96	90	91	89	91	93	550	0
Marshall Grant	Coast Guard	Nov. 18, 2016	Coast Guard	86	88	97	94	77	83	525	0	93	95	92	91	98	94	563	0
Alexandria Harrington	Coast Guard	Nov. 18, 2016	Coast Guard	0	0	0	0	0	0	0	0	0	0	0	0	0	0	0	0
Anthony Lee	Coast Guard	Nov. 18, 2016	Coast Guard	0	0	0	0	0	0	0	0	0	0	0	0	0	0	0	0
Dylan Lorence	Coast Guard	Nov. 18, 2016	Coast Guard	0	0	0	0	0	0	0	0	0	0	0	0	0	0	0	0
Kaden Nichols	Coast Guard	Nov. 18, 2016	Coast Guard	0	0	0	0	0	0	0	0	0	0	0	0	0	0	0	0
Nicholas Paisker	Coast Guard	Nov. 18, 2016	Coast Guard	0	0	0	0	0	0	0	0	0	0	0	0	0	0	0	0
Paul Raynolds	Coast Guard	Nov. 18, 2016	Coast Guard	0	0	0	0	0	0	0	0	0	0	0	0	0	0	0	0
David Rose	Coast Guard	Nov. 18, 2016	Coast Guard	0	0	0	0	0	0	0	0	0	0	0	0	0	0	0	0
Alaric Stone	Coast Guard	Nov. 18, 2016	Coast Guard	0	0	0	0	0	0	0	0	0	0	0	0	0	0	0	0
Nyjah Turner	Coast Guard	Nov. 18, 2016	Coast Guard	0	0	0	0	0	0	0	0	0	0	0	0	0	0	0	0
Rachel Hubal	USciences	Nov. 18, 2016	Coast Guard	0	0	0	0	0	0	0	0	0	0	0	0	0	0	0	0
Angela Kang	USciences	Nov. 18, 2016	Coast Guard	0	0	0	0	0	0	0	0	0	0	0	0	0	0	0	0
Brittany Mahoney	USciences	Nov. 18, 2016	Coast Guard	0	0	0	0	0	0	0	0	0	0	0	0	0	0	0	0
Chris Makosiej	USciences	Nov. 18, 2016	Coast Guard	0	0	0	0	0	0	0	0	0	0	0	0	0	0	0	0
Nick Makosiej	USciences	Nov. 18, 2016	Coast Guard	0	0	0	0	0	0	0	0	0	0	0	0	0	0	0	0
Thomas Nelligan	USciences	Nov. 18, 2016	Coast Guard	0	0	0	0	0	0	0	0	0	0	0	0	0	0	0	0
Matt Popowicz	USciences	Nov. 18, 2016	Coast Guard	0	0	0	0	0	0	0	0	0	0	0	0	0	0	0	0
Andrej Quatrone	USciences	Nov. 18, 2016	Coast Guard	0	0	0	0	0	0	0	0	0	0	0	0	0	0	0	0
Sarah Schnupp	USciences	Nov. 18, 2016	Coast Guard	0	0	0	0	0	0	0	0	0	0	0	0	0	0	0	0
Lauren Stabler	USciences	Nov. 18, 2016	Coast Guard	0	0	0	0	0	0	0	0	0	0	0	0	0	0	0	0
Christina Tipton	USciences	Nov. 18, 2016	Coast Guard	0	0	0	0	0	0	0	0	0	0	0	0	0	0	0	0
Allie Tuman	USciences	Nov. 18, 2016	Coast Guard	0	0	0	0	0	0	0	0	0	0	0	0	0	0	0	0
Anita Varkey	USciences	Nov. 18, 2016	Coast Guard	0	0	0	0	0	0	0	0	0	0	0	0	0	0	0	0
Andrew Visconti	USciences	Nov. 18, 2016	Coast Guard	0	0	0	0	0	0	0	0	0	0	0	0	0	0	0	0
Nick Zsoldos	USciences	Nov. 18, 2016	Coast Guard	0	0	0	0	0	0	0	0	0	0	0	0	0	0	0	0
Melissa Brizzi	Coast Guard	Nov. 18, 2016	Coast Guard	93	88	94	98	75	83	531	0	92	88	91	93	86	89	539	0
Joseph Busching	Coast Guard	Nov. 18, 2016	Coast Guard	0	0	0	0	0	0	0	0	88	91	91	87	89	91	537	0
Jacob Dupree	Coast Guard	Nov. 18, 2016	Coast Guard	91	94	91	92	79	91	538	0	93	89	91	87	86	92	538	0
Randall Ford	Coast Guard	Nov. 18, 2016	Coast Guard	92	91	94	98	81	83	539	0	96	90	91	89	91	93	550	0
Marshall Grant	Coast Guard	Nov. 18, 2016	Coast Guard	86	88	97	94	77	83	525	0	93	95	92	91	98	94	563	0
Alexandria Harrington	Coast Guard	Nov. 18, 2016	Coast Guard	0	0	0	0	0	0	0	0	0	0	0	0	0	0	0	0
Anthony Lee	Coast Guard	Nov. 18, 2016	Coast Guard	0	0	0	0	0	0	0	0	0	0	0	0	0	0	0	0
Dylan Lorence	Coast Guard	Nov. 18, 2016	Coast Guard	0	0	0	0	0	0	0	0	0	0	0	0	0	0	0	0
Kaden Nichols	Coast Guard	Nov. 18, 2016	Coast Guard	0	0	0	0	0	0	0	0	0	0	0	0	0	0	0	0
Nicholas Paisker	Coast Guard	Nov. 18, 2016	Coast Guard	0	0	0	0	0	0	0	0	0	0	0	0	0	0	0	0
Paul Raynolds	Coast Guard	Nov. 18, 2016	Coast Guard	0	0	0	0	0	0	0	0	0	0	0	0	0	0	0	0
David Rose	Coast Guard	Nov. 18, 2016	Coast Guard	0	0	0	0	0	0	0	0	0	0	0	0	0	0	0	0
Alaric Stone	Coast Guard	Nov. 18, 2016	Coast Guard	0	0	0	0	0	0	0	0	0	0	0	0	0	0	0	0
Nyjah Turner	Coast Guard	Nov. 18, 2016	Coast Guard	0	0	0	0	0	0	0	0	0	0	0	0	0	0	0	0
Rachel Hubal	USciences	Nov. 18, 2016	Coast Guard	0	0	0	0	0	0	0	0	0	0	0	0	0	0	0	0
Angela Kang	USciences	Nov. 18, 2016	Coast Guard	0	0	0	0	0	0	0	0	0	0	0	0	0	0	0	0
Brittany Mahoney	USciences	Nov. 18, 2016	Coast Guard	0	0	0	0	0	0	0	0	0	0	0	0	0	0	0	0
Chris Makosiej	USciences	Nov. 18, 2016	Coast Guard	0	0	0	0	0	0	0	0	0	0	0	0	0	0	0	0
Nick Makosiej	USciences	Nov. 18, 2016	Coast Guard	0	0	0	0	0	0	0	0	0	0	0	0	0	0	0	0
Thomas Nelligan	USciences	Nov. 18, 2016	Coast Guard	0	0	0	0	0	0	0	0	0	0	0	0	0	0	0	0
Matt Popowicz	USciences	Nov. 18, 2016	Coast Guard	0	0	0	0	0	0	0	0	0	0	0	0	0	0	0	0
Andrej Quatrone	USciences	Nov. 18, 2016	Coast Guard	0	0	0	0	0	0	0	0	0	0	0	0	0	0	0	0
Sarah Schnupp	USciences	Nov. 18, 2016	Coast Guard	0	0	0	0	0	0	0	0	0	0	0	0	0	0	0	0
Lauren Stabler	USciences	Nov. 18, 2016	Coast Guard	0	0	0	0	0	0	0	0	0	0	0	0	0	0	0	0
Christina Tipton	USciences	Nov. 18, 2016	Coast Guard	0	0	0	0	0	0	0	0	0	0	0	0	0	0	0	0
Allie Tuman	USciences	Nov. 18, 2016	Coast Guard	0	0	0	0	0	0	0	0	0	0	0	0	0	0	0	0
Anita Varkey	USciences	Nov. 18, 2016	Coast Guard	0	0	0	0	0	0	0	0	0	0	0	0	0	0	0	0
Andrew Visconti	USciences	Nov. 18, 2016	Coast Guard	0	0	0	0	0	0	0	0	0	0	0	0	0	0	0	0
Nick Zsoldos	USciences	Nov. 18, 2016	Coast Guard	0	0	0	0	0	0	0	0	0	0	0	0	0	0	0	0
Bobby Broadstreet	Murray St.	Nov. 18, 2016	Jacksonville St.	95	96	100	98	91	92	572	0	94	100	100	99	99	99	591	0
Meike Drewell	Murray St.	Nov. 18, 2016	Jacksonville St.	94	97	99	98	94	94	576	0	98	98	98	97	98	97	586	0
Ben Estes	Murray St.	Nov. 18, 2016	Jacksonville St.	98	97	98	98	96	97	584	0	100	98	99	98	99	99	593	0
Shelby Huber	Murray St.	Nov. 18, 2016	Jacksonville St.	0	0	0	0	0	0	0	0	0	0	0	0	0	0	0	0
Mackenzie Martin	Murray St.	Nov. 18, 2016	Jacksonville St.	95	96	100	99	97	97	584	0	100	96	100	100	99	99	594	0
Ivan Roe	Murray St.	Nov. 18, 2016	Jacksonville St.	99	99	100	99	98	99	594	0	100	99	100	99	98	98	594	0
Barbara Schlapfer	Murray St.	Nov. 18, 2016	Jacksonville St.	99	98	99	100	94	96	586	0	98	100	98	99	98	98	591	0
Alathea Sellars	Murray St.	Nov. 18, 2016	Jacksonville St.	98	100	99	99	97	97	590	0	95	97	98	99	99	99	587	0
Eric Sloan	Murray St.	Nov. 18, 2016	Jacksonville St.	0	0	0	0	0	0	0	0	0	0	0	0	0	0	0	0
Andrew Abernathy	North Georgia	Nov. 18, 2016	Jacksonville St.	93	93	100	95	92	94	567	0	96	90	95	94	95	97	567	0
Eric Azotea	North Georgia	Nov. 18, 2016	Jacksonville St.	0	0	0	0	0	0	0	0	0	0	0	0	0	0	0	0
Ruthanne Conner	North Georgia	Nov. 18, 2016	Jacksonville St.	93	97	100	99	90	92	571	0	93	97	99	91	95	93	568	0
Lucas Gilliland	North Georgia	Nov. 18, 2016	Jacksonville St.	94	91	99	97	84	83	548	0	97	97	94	97	95	95	575	0
Maddie Godwin	North Georgia	Nov. 18, 2016	Jacksonville St.	0	0	0	0	0	0	0	0	0	0	0	0	0	0	0	0
Hannah Peevy	North Georgia	Nov. 18, 2016	Jacksonville St.	0	0	0	0	0	0	0	0	0	0	0	0	0	0	0	0
Jared Rice	North Georgia	Nov. 18, 2016	Jacksonville St.	93	95	97	99	93	91	568	0	93	91	95	91	96	97	563	0
Tobin Sanctuary	North Georgia	Nov. 18, 2016	Jacksonville St.	97	96	99	98	85	89	564	0	93	95	95	95	95	94	567	0
Brianna Shaw	North Georgia	Nov. 18, 2016	Jacksonville St.	0	0	0	0	0	0	0	0	0	0	0	0	0	0	0	0
Dakota Spivey	North Georgia	Nov. 18, 2016	Jacksonville St.	98	96	98	98	93	96	579	0	99	98	95	96	95	98	581	0
David Turner	North Georgia	Nov. 18, 2016	Jacksonville St.	85	94	100	96	83	91	549	0	95	97	95	94	96	94	571	0
Jack Berhorst	Memphis	Nov. 18, 2016	Jacksonville St.	96	97	99	98	92	93	575	0	94	92	96	97	95	95	569	0
Haylea Broughton	Memphis	Nov. 18, 2016	Jacksonville St.	96	99	97	97	93	97	579	0	98	97	100	99	98	99	591	0
Levi Clark	Memphis	Nov. 18, 2016	Jacksonville St.	96	94	100	99	94	96	579	0	97	100	98	97	97	97	586	0
Leighton Dempster	Memphis	Nov. 18, 2016	Jacksonville St.	96	92	98	96	95	88	565	0	98	99	98	99	95	99	588	0
Makennon Doran	Memphis	Nov. 18, 2016	Jacksonville St.	0	0	0	0	0	0	0	0	0	0	0	0	0	0	0	0
Amberlie Ezell	Memphis	Nov. 18, 2016	Jacksonville St.	0	0	0	0	0	0	0	0	96	95	98	97	99	94	579	0
Amy Fister	Memphis	Nov. 18, 2016	Jacksonville St.	96	98	100	100	96	94	584	0	99	95	99	97	99	96	585	0
Eli Rischling	Memphis	Nov. 18, 2016	Jacksonville St.	96	96	99	100	91	81	563	0	95	95	97	95	97	96	575	0
Abby Votava	Memphis	Nov. 18, 2016	Jacksonville St.	90	87	92	95	89	87	540	0	96	94	98	97	96	93	574	0
Hunter Behrends	Jacksonville St.	Nov. 18, 2016	Jacksonville St.	94	91	91	94	91	88	549	0	94	92	93	93	96	95	563	0
Austin Cock	Jacksonville St.	Nov. 18, 2016	Jacksonville St.	97	94	98	98	94	90	571	0	99	97	98	99	96	98	587	0
Anika Corsi	Jacksonville St.	Nov. 18, 2016	Jacksonville St.	0	0	0	0	0	0	0	0	93	94	98	98	97	96	576	0
Trace Haynes	Jacksonville St.	Nov. 18, 2016	Jacksonville St.	96	93	98	98	86	83	554	0	95	99	95	94	97	98	578	0
Brandon Henson	Jacksonville St.	Nov. 18, 2016	Jacksonville St.	0	0	0	0	0	0	0	0	97	96	95	97	97	95	577	0
Brandon Muske	Jacksonville St.	Nov. 18, 2016	Jacksonville St.	97	98	96	95	92	89	567	0	99	98	99	99	100	98	593	0
Kyle Ordille	Jacksonville St.	Nov. 18, 2016	Jacksonville St.	93	91	96	97	95	92	564	0	95	97	94	97	91	94	568	0
Carleigh Peters	Jacksonville St.	Nov. 18, 2016	Jacksonville St.	96	93	98	98	91	90	566	0	98	98	96	96	93	98	579	0
Garrett Rabel	Jacksonville St.	Nov. 18, 2016	Jacksonville St.	98	98	100	99	90	92	577	0	96	93	96	97	96	96	574	0
Tyler Ramos	Jacksonville St.	Nov. 18, 2016	Jacksonville St.	98	98	98	98	91	90	573	0	96	96	97	100	97	97	583	0
Mekenna Richardson	Jacksonville St.	Nov. 18, 2016	Jacksonville St.	97	98	98	98	91	96	578	0	95	100	94	94	96	95	574	0
Carter Santrock	Jacksonville St.	Nov. 18, 2016	Jacksonville St.	91	98	99	97	92	92	569	0	95	96	97	96	99	99	582	0
Zach Schmidt	Jacksonville St.	Nov. 18, 2016	Jacksonville St.	96	97	100	99	94	97	583	0	97	96	98	95	96	96	578	0
David Sink	Jacksonville St.	Nov. 18, 2016	Jacksonville St.	95	99	96	99	91	95	575	0	96	96	96	97	98	98	581	0
Sarah Banks	Alabama Birmingham	Nov. 18, 2016	Jacksonville St.	0	0	0	0	0	0	0	0	93	92	95	98	94	87	559	0
Steven Bugg	Alabama Birmingham	Nov. 18, 2016	Jacksonville St.	0	0	0	0	0	0	0	0	78	88	82	87	77	85	497	0
Selina Curren	Alabama Birmingham	Nov. 18, 2016	Jacksonville St.	0	0	0	0	0	0	0	0	96	97	94	96	96	93	572	0
Lindsey Hill	Alabama Birmingham	Nov. 18, 2016	Jacksonville St.	0	0	0	0	0	0	0	0	0	0	0	0	0	0	0	0
Isaac King	Alabama Birmingham	Nov. 18, 2016	Jacksonville St.	0	0	0	0	0	0	0	0	91	89	86	87	87	90	530	0
Kristie Lloyd	Alabama Birmingham	Nov. 18, 2016	Jacksonville St.	0	0	0	0	0	0	0	0	90	95	93	95	94	94	561	0
Logan Short	Alabama Birmingham	Nov. 18, 2016	Jacksonville St.	0	0	0	0	0	0	0	0	76	71	81	81	81	77	467	0
Mallory Sisk	Alabama Birmingham	Nov. 18, 2016	Jacksonville St.	0	0	0	0	0	0	0	0	0	0	0	0	0	0	0	0
Micah Smith	Alabama Birmingham	Nov. 18, 2016	Jacksonville St.	0	0	0	0	0	0	0	0	0	0	0	0	0	0	0	0
Emily Stover	Alabama Birmingham	Nov. 18, 2016	Jacksonville St.	0	0	0	0	0	0	0	0	95	94	94	94	91	92	560	0
Ella Von Canon	Alabama Birmingham	Nov. 18, 2016	Jacksonville St.	0	0	0	0	0	0	0	0	94	91	90	96	94	93	558	0
Lilly Vonderau	Alabama Birmingham	Nov. 18, 2016	Jacksonville St.	0	0	0	0	0	0	0	0	92	94	93	96	98	94	567	0
Kealie Engels	Wofford	Nov. 19, 2016	Ga. Southern	0	0	0	0	0	0	0	0	0	0	0	0	0	0	0	0
Seth Flanagan	Wofford	Nov. 19, 2016	Ga. Southern	87	86	92	92	87	82	526	8	93	94	91	93	93	87	551	17
Cierra Holcombe	Wofford	Nov. 19, 2016	Ga. Southern	94	93	96	98	96	94	571	24	92	93	93	92	93	95	558	18
Carson Howell	Wofford	Nov. 19, 2016	Ga. Southern	0	0	0	0	0	0	0	0	0	0	0	0	0	0	0	0
Nicholas Hunter	Wofford	Nov. 19, 2016	Ga. Southern	85	84	96	95	88	83	531	6	89	91	92	91	93	97	553	12
Zachry Hunter	Wofford	Nov. 19, 2016	Ga. Southern	0	0	0	0	0	0	0	0	90	89	81	84	85	91	520	9
Reid Schuster	Wofford	Nov. 19, 2016	Ga. Southern	83	74	90	93	83	82	505	3	88	91	84	85	85	89	522	12
Rosemary Kramer	Ga. Southern	Nov. 19, 2016	Ga. Southern	89	94	98	91	89	84	545	13	92	95	96	97	98	98	576	31
Tori Lewis	Ga. Southern	Nov. 19, 2016	Ga. Southern	90	87	96	93	91	86	543	14	92	95	97	93	94	97	568	20
Jennifer Middlebrook	Ga. Southern	Nov. 19, 2016	Ga. Southern	0	0	0	0	0	0	0	0	0	0	0	0	0	0	0	0
Lydia Odlin	Ga. Southern	Nov. 19, 2016	Ga. Southern	90	92	96	96	82	79	535	10	92	93	91	90	94	92	552	13
Chastity Price	Ga. Southern	Nov. 19, 2016	Ga. Southern	89	91	93	92	84	83	532	7	82	90	91	91	91	91	536	17
Courtney Weekley	Ga. Southern	Nov. 19, 2016	Ga. Southern	93	91	92	93	90	93	552	16	94	95	95	97	96	95	572	18
Kathryn Youngblood	Ga. Southern	Nov. 19, 2016	Ga. Southern	0	0	0	0	0	0	0	0	0	0	0	0	0	0	0	0
Soren Butler	Alaska Fairbanks	Nov. 19, 2016	Alaska Fairbanks	93	93	96	97	95	98	572	20	99	98	100	97	98	99	591	42
Liam Eberhart	Alaska Fairbanks	Nov. 19, 2016	Alaska Fairbanks	95	97	99	99	89	91	570	20	96	96	99	100	97	97	585	36
Amy Gentry	Alaska Fairbanks	Nov. 19, 2016	Alaska Fairbanks	97	93	98	98	94	92	572	21	99	99	98	95	98	96	585	35
Luke Johnson	Alaska Fairbanks	Nov. 19, 2016	Alaska Fairbanks	95	98	98	97	95	97	580	28	96	98	97	96	97	99	583	37
Sagen Maddalena	Alaska Fairbanks	Nov. 19, 2016	Alaska Fairbanks	96	97	98	100	98	93	582	29	99	100	98	100	98	99	594	48
Grace Nelson	Alaska Fairbanks	Nov. 19, 2016	Alaska Fairbanks	95	95	99	98	91	95	573	24	97	95	99	94	96	99	580	32
JT Schnering	Alaska Fairbanks	Nov. 19, 2016	Alaska Fairbanks	98	96	99	100	89	95	577	24	100	100	99	96	98	97	590	41
Robert Scott	Alaska Fairbanks	Nov. 19, 2016	Alaska Fairbanks	98	93	100	96	89	94	570	24	95	96	96	97	96	98	578	33
Nathan Taylor	Alaska Fairbanks	Nov. 19, 2016	Alaska Fairbanks	94	92	96	99	92	91	564	17	96	100	100	98	97	100	591	44
Billy Azzinaro	Kentucky	Nov. 19, 2016	Alaska Fairbanks	94	94	99	100	92	95	574	29	100	98	99	94	98	99	588	46
Jenna Bethea	Kentucky	Nov. 19, 2016	Alaska Fairbanks	95	94	98	94	93	94	568	23	96	97	98	97	94	100	582	34
Hanna Carr	Kentucky	Nov. 19, 2016	Alaska Fairbanks	98	95	100	99	92	95	579	31	100	99	97	97	98	98	589	39
Morgan Duerr	Kentucky	Nov. 19, 2016	Alaska Fairbanks	88	94	99	99	90	92	562	18	98	98	95	95	98	98	582	27
Ian Foos	Kentucky	Nov. 19, 2016	Alaska Fairbanks	93	95	96	97	94	96	571	19	97	97	99	99	96	97	585	34
Carmen Fry	Kentucky	Nov. 19, 2016	Alaska Fairbanks	93	95	99	97	90	91	565	20	98	98	96	99	92	98	581	38
Heather Kirby	Kentucky	Nov. 19, 2016	Alaska Fairbanks	99	91	98	99	93	91	571	22	100	98	99	100	100	98	595	45
Sonya May	Kentucky	Nov. 19, 2016	Alaska Fairbanks	98	94	98	97	97	96	580	25	98	99	99	98	98	94	586	37
Andrew Miller	Kentucky	Nov. 19, 2016	Alaska Fairbanks	0	0	0	0	0	0	0	0	0	0	0	0	0	0	0	0
Cathryn Papasodora	Kentucky	Nov. 19, 2016	Alaska Fairbanks	91	93	97	98	96	96	571	23	99	96	98	98	100	100	591	47
Jason Scharbel	Kentucky	Nov. 19, 2016	Alaska Fairbanks	93	97	99	99	94	94	576	25	99	96	96	98	99	99	587	34
Jason Spaude	Kentucky	Nov. 19, 2016	Alaska Fairbanks	93	93	100	98	90	92	566	20	97	99	97	99	99	97	588	38
Angelica Dearaujo	John Jay	Nov. 19, 2016	MIT	87	81	90	91	85	89	523	0	96	94	95	93	92	94	564	0
Angelica Dearaujo	John Jay	Nov. 19, 2016	MIT	0	0	0	0	0	0	0	0	0	0	0	0	0	0	0	0
Lily Graham	John Jay	Nov. 19, 2016	MIT	92	86	94	96	88	89	545	0	98	97	95	91	92	96	569	0
Lily Graham	John Jay	Nov. 19, 2016	MIT	0	0	0	0	0	0	0	0	0	0	0	0	0	0	0	0
Ronald Kopec	John Jay	Nov. 19, 2016	MIT	86	90	92	93	84	90	535	0	94	92	92	94	92	96	560	0
Ronald Kopec	John Jay	Nov. 19, 2016	MIT	86	90	0	0	0	0	176	0	0	0	0	0	0	0	0	0
Eliza Kotowska	John Jay	Nov. 19, 2016	MIT	0	0	0	0	0	0	0	0	0	0	0	0	0	0	0	0
Eliza Kotowska	John Jay	Nov. 19, 2016	MIT	0	0	0	0	0	0	0	0	0	0	0	0	0	0	0	0
Susana Sanchez	John Jay	Nov. 19, 2016	MIT	81	75	88	89	76	80	489	0	93	83	92	94	90	90	542	0
Susana Sanchez	John Jay	Nov. 19, 2016	MIT	0	0	0	0	0	0	0	0	0	0	0	0	0	0	0	0
Ida Sato	John Jay	Nov. 19, 2016	MIT	79	80	87	87	85	73	491	0	96	92	94	95	96	91	564	0
Ida Sato	John Jay	Nov. 19, 2016	MIT	0	0	0	0	0	0	0	0	0	0	0	0	0	0	0	0
Marc Suda	John Jay	Nov. 19, 2016	MIT	80	83	94	91	69	90	507	0	82	85	93	84	89	94	527	0
Marc Suda	John Jay	Nov. 19, 2016	MIT	80	83	0	0	0	0	163	0	0	0	0	0	0	0	0	0
William Caruso	MIT	Nov. 19, 2016	MIT	88	89	94	85	89	81	526	0	92	84	88	89	93	93	539	0
Efraim Helman	MIT	Nov. 19, 2016	MIT	0	0	0	0	0	0	0	0	0	0	0	0	0	0	0	0
Yaakov Helman	MIT	Nov. 19, 2016	MIT	0	0	0	0	0	0	0	0	0	0	0	0	0	0	0	0
Jesus Herrera	MIT	Nov. 19, 2016	MIT	84	80	90	91	80	71	496	0	85	85	85	80	86	83	504	0
Alexander Laiman	MIT	Nov. 19, 2016	MIT	0	0	0	0	0	0	0	0	0	0	0	0	0	0	0	0
Gregory Lee	MIT	Nov. 19, 2016	MIT	90	75	84	90	77	82	498	0	87	90	90	94	88	93	542	0
Kelly Mathesius	MIT	Nov. 19, 2016	MIT	90	84	94	93	85	89	535	0	92	94	94	95	92	96	563	0
Elijah Miller	MIT	Nov. 19, 2016	MIT	0	0	0	0	0	0	0	0	0	0	0	0	0	0	0	0
Dylan Modesitt	MIT	Nov. 19, 2016	MIT	87	88	93	94	81	77	520	0	83	83	89	83	92	90	520	0
Kevin Ng	MIT	Nov. 19, 2016	MIT	0	0	0	0	0	0	0	0	0	0	0	0	0	0	0	0
Alex Pacheco	MIT	Nov. 19, 2016	MIT	74	79	88	87	75	71	474	0	76	81	78	88	84	82	489	0
Kevin Petrovic	MIT	Nov. 19, 2016	MIT	83	81	91	91	77	71	494	0	77	78	80	75	76	85	471	0
Thomas Rick	MIT	Nov. 19, 2016	MIT	82	77	90	86	74	73	482	0	84	87	85	91	86	87	520	0
Joel Solis	MIT	Nov. 19, 2016	MIT	82	82	95	89	78	76	502	0	95	79	94	93	91	90	542	0
George Conde	John Jay	Nov. 19, 2016	MIT	84	83	88	86	77	84	502	0	88	87	87	88	82	88	520	0
Nathan Brewer	Army	Nov. 20, 2016	Army	96	99	100	100	94	91	580	35	94	98	95	97	98	96	578	33
Emiliano Concha-Toro	Army	Nov. 20, 2016	Army	92	89	100	98	91	97	567	25	93	93	98	95	98	97	574	29
Ethan Cook	Army	Nov. 20, 2016	Army	97	92	97	98	89	88	561	20	97	97	97	97	96	97	581	32
Danielle Cuomo	Army	Nov. 20, 2016	Army	96	93	97	100	96	94	576	22	98	98	98	99	99	95	587	39
Maggie Ehmann	Army	Nov. 20, 2016	Army	0	0	0	0	0	0	0	0	98	96	98	94	98	91	575	29
Maddy Erikson	Army	Nov. 20, 2016	Army	92	92	96	99	91	91	561	20	97	96	98	96	99	99	585	38
Mike Garner	Army	Nov. 20, 2016	Army	98	98	96	99	88	89	568	25	96	99	95	94	94	95	573	27
Nick Kanellis	Army	Nov. 20, 2016	Army	96	94	99	98	94	87	568	23	97	83	97	95	99	97	568	26
Marvin Lewis	Army	Nov. 20, 2016	Army	95	98	95	97	92	90	567	23	99	99	96	100	98	98	590	44
Rhianna Lichtenthal	Army	Nov. 20, 2016	Army	0	0	0	0	0	0	0	0	0	0	0	0	0	0	0	0
Libby Mostert	Army	Nov. 20, 2016	Army	89	96	96	98	91	93	563	16	96	97	96	97	96	97	579	34
Sarah Nakata	Army	Nov. 20, 2016	Army	0	0	0	0	0	0	0	0	0	0	0	0	0	0	0	0
Payne Nunn	Army	Nov. 20, 2016	Army	99	96	100	95	95	94	579	23	99	99	99	97	97	97	588	35
Allen Solida	Army	Nov. 20, 2016	Army	94	95	99	98	93	93	572	26	97	97	98	99	99	97	587	35
Andrew Solomonides	Army	Nov. 20, 2016	Army	91	91	98	98	87	95	560	19	98	93	95	97	96	97	576	27
Nicholle Benedict	TCU	Nov. 20, 2016	Army	0	0	0	0	0	0	0	0	0	0	0	0	0	0	0	0
Katie Bridges	TCU	Nov. 20, 2016	Army	0	0	0	0	0	0	0	0	0	0	0	0	0	0	0	0
Rachel Garner	TCU	Nov. 20, 2016	Army	99	99	100	100	97	98	593	32	99	99	98	97	100	99	592	41
Ariana Grabowski	TCU	Nov. 20, 2016	Army	99	97	98	100	97	94	585	26	98	98	96	98	93	99	582	34
Emily Haag	TCU	Nov. 20, 2016	Army	0	0	0	0	0	0	0	0	0	0	0	0	0	0	0	0
Nicole Hankey	TCU	Nov. 20, 2016	Army	98	98	96	96	97	95	580	33	98	98	97	100	97	98	588	42
Rachel Kimbell	TCU	Nov. 20, 2016	Army	94	95	98	98	96	90	571	23	97	99	99	98	95	98	586	40
Sally Li	TCU	Nov. 20, 2016	Army	97	96	99	98	95	93	578	25	99	99	99	98	100	99	594	41
Casey Lutz	TCU	Nov. 20, 2016	Army	97	100	99	98	96	96	586	37	99	97	100	99	99	99	593	49
Mindy Miles	TCU	Nov. 20, 2016	Army	96	96	97	99	100	97	585	33	100	100	100	99	100	99	598	49
Catherine Miller	TCU	Nov. 20, 2016	Army	91	97	99	93	91	88	559	12	98	97	99	97	98	99	588	44
Meraleigh Randle	TCU	Nov. 20, 2016	Army	0	0	0	0	0	0	0	0	0	0	0	0	0	0	0	0
Barrett Ray	TCU	Nov. 20, 2016	Army	96	97	100	99	94	93	579	28	98	99	100	97	100	98	592	43
Soren Butler	Alaska Fairbanks	Nov. 20, 2016	Alaska Fairbanks	96	92	99	99	96	98	580	30	98	99	99	97	96	99	588	40
Liam Eberhart	Alaska Fairbanks	Nov. 20, 2016	Alaska Fairbanks	96	95	98	97	94	95	575	27	98	97	98	97	97	97	584	38
Amy Gentry	Alaska Fairbanks	Nov. 20, 2016	Alaska Fairbanks	96	98	99	99	96	93	581	20	99	96	98	99	93	98	583	36
Luke Johnson	Alaska Fairbanks	Nov. 20, 2016	Alaska Fairbanks	93	94	99	98	97	94	575	25	98	98	96	98	97	96	583	34
Sagen Maddalena	Alaska Fairbanks	Nov. 20, 2016	Alaska Fairbanks	97	96	99	99	97	98	586	36	100	100	99	99	99	99	596	49
Grace Nelson	Alaska Fairbanks	Nov. 20, 2016	Alaska Fairbanks	92	96	96	96	92	92	564	16	96	97	96	98	93	97	577	29
JT Schnering	Alaska Fairbanks	Nov. 20, 2016	Alaska Fairbanks	95	96	99	99	96	94	579	32	99	96	98	96	99	99	587	41
Robert Scott	Alaska Fairbanks	Nov. 20, 2016	Alaska Fairbanks	97	94	98	100	95	91	575	24	100	98	98	97	99	100	592	46
Nathan Taylor	Alaska Fairbanks	Nov. 20, 2016	Alaska Fairbanks	90	92	98	93	92	92	557	17	97	92	94	96	91	94	564	19
Zach Eisenberg	North Carolina St.	Nov. 20, 2016	Alaska Fairbanks	0	0	0	0	0	0	0	0	0	0	0	0	0	0	0	0
Caitlyn Ford	North Carolina St.	Nov. 20, 2016	Alaska Fairbanks	97	99	95	88	92	93	564	22	100	98	99	100	98	96	591	46
Sarah Hickey	North Carolina St.	Nov. 20, 2016	Alaska Fairbanks	0	0	0	0	0	0	0	0	0	0	0	0	0	0	0	0
Lucas Kozeniesky	North Carolina St.	Nov. 20, 2016	Alaska Fairbanks	97	98	99	99	95	94	582	31	99	100	99	99	100	100	597	50
Tyler Lefebvre	North Carolina St.	Nov. 20, 2016	Alaska Fairbanks	0	0	0	0	0	0	0	0	0	0	0	0	0	0	0	0
Will Marciniak	North Carolina St.	Nov. 20, 2016	Alaska Fairbanks	97	96	99	98	92	91	573	26	96	97	98	98	94	98	581	33
Derya Pekari	North Carolina St.	Nov. 20, 2016	Alaska Fairbanks	91	92	96	95	93	93	560	12	95	96	98	98	97	99	583	35
Lauren Phillips	North Carolina St.	Nov. 20, 2016	Alaska Fairbanks	88	90	99	98	96	96	567	22	97	100	99	98	99	97	590	46
Claire Spina	North Carolina St.	Nov. 20, 2016	Alaska Fairbanks	0	0	0	0	0	0	0	0	0	0	0	0	0	0	0	0
Cullen Wargo	North Carolina St.	Nov. 20, 2016	Alaska Fairbanks	0	0	0	0	0	0	0	0	0	0	0	0	0	0	0	0
George Williams	North Carolina St.	Nov. 20, 2016	Alaska Fairbanks	0	0	0	0	0	0	0	0	0	0	0	0	0	0	0	0
Claire Zanti	North Carolina St.	Nov. 20, 2016	Alaska Fairbanks	95	94	99	99	87	93	567	21	99	100	100	94	98	96	587	36
Soren Butler	Alaska Fairbanks	Jan. 10, 2017	West Virginia	96	95	95	98	95	95	574	0	99	99	98	98	98	97	589	0
Liam Eberhart	Alaska Fairbanks	Jan. 10, 2017	West Virginia	0	0	0	0	0	0	0	0	0	0	0	0	0	0	0	0
Amy Gentry	Alaska Fairbanks	Jan. 10, 2017	West Virginia	96	97	100	99	95	95	582	0	96	99	94	98	97	98	582	0
Luke Johnson	Alaska Fairbanks	Jan. 10, 2017	West Virginia	96	98	99	100	98	97	588	0	96	99	99	99	100	99	592	0
Sagen Maddalena	Alaska Fairbanks	Jan. 10, 2017	West Virginia	95	99	99	100	96	93	582	0	99	100	99	100	100	100	598	0
Grace Nelson	Alaska Fairbanks	Jan. 10, 2017	West Virginia	89	96	96	97	89	91	558	0	96	95	95	95	92	97	570	0
JT Schnering	Alaska Fairbanks	Jan. 10, 2017	West Virginia	95	91	98	96	91	96	567	0	94	98	97	98	99	98	584	0
Robert Scott	Alaska Fairbanks	Jan. 10, 2017	West Virginia	95	95	99	100	92	94	575	0	99	99	97	99	99	87	580	0
Nathan Taylor	Alaska Fairbanks	Jan. 10, 2017	West Virginia	0	0	0	0	0	0	0	0	0	0	0	0	0	0	0	0
Jack Anderson	West Virginia	Jan. 10, 2017	West Virginia	94	89	97	97	90	94	561	0	98	96	99	99	98	95	585	0
Will Anti	West Virginia	Jan. 10, 2017	West Virginia	92	97	99	100	97	94	579	0	99	99	97	99	98	98	590	0
Milica Babic	West Virginia	Jan. 10, 2017	West Virginia	95	94	100	100	98	94	581	0	100	99	100	99	100	99	597	0
Noah Barker	West Virginia	Jan. 10, 2017	West Virginia	0	0	0	0	0	0	0	0	0	0	0	0	0	0	0	0
Elizabeth Gratz	West Virginia	Jan. 10, 2017	West Virginia	99	96	98	99	97	98	587	0	98	98	99	97	94	99	585	0
Jean-Pierre Lucas	West Virginia	Jan. 10, 2017	West Virginia	98	100	99	98	95	95	585	0	99	99	99	99	98	98	592	0
Morgan Phillips	West Virginia	Jan. 10, 2017	West Virginia	95	92	96	98	97	98	576	0	100	95	99	98	98	98	588	0
Ginny Thrasher	West Virginia	Jan. 10, 2017	West Virginia	99	97	99	100	96	99	590	0	98	100	100	100	99	100	597	0
Lauryn Cinadr	Akron	Jan. 14, 2017	Palmyra Range	92	93	97	97	91	92	562	17	95	97	97	98	97	95	579	28
Alex Fedorko	Akron	Jan. 14, 2017	Palmyra Range	90	91	96	96	84	77	534	14	94	98	93	94	92	94	565	19
Sydney Goldschlag	Akron	Jan. 14, 2017	Palmyra Range	0	0	0	0	0	0	0	0	0	0	0	0	0	0	0	0
Rebecca Green	Akron	Jan. 14, 2017	Palmyra Range	94	86	94	94	85	84	537	10	97	95	98	97	97	93	577	29
Julia Hatch	Akron	Jan. 14, 2017	Palmyra Range	95	94	96	98	92	90	565	21	98	97	96	94	92	94	571	23
Anthony Jackson	Akron	Jan. 14, 2017	Palmyra Range	91	96	99	98	94	92	570	24	98	99	98	98	96	99	588	37
Kera Kaufman	Akron	Jan. 14, 2017	Palmyra Range	87	93	98	94	92	90	554	18	98	97	97	98	97	94	581	34
Joshua Kovach	Akron	Jan. 14, 2017	Palmyra Range	0	0	0	0	0	0	0	0	0	0	0	0	0	0	0	0
Caleb Lloyd	Akron	Jan. 14, 2017	Palmyra Range	97	94	98	99	88	91	567	31	96	98	97	100	97	95	583	30
Danielle Makucevich	Akron	Jan. 14, 2017	Palmyra Range	0	0	0	0	0	0	0	0	0	0	0	0	0	0	0	0
Kris Mantel	Akron	Jan. 14, 2017	Palmyra Range	0	0	0	0	0	0	0	0	0	0	0	0	0	0	0	0
Brent Morgan	Akron	Jan. 14, 2017	Palmyra Range	0	0	0	0	0	0	0	0	0	0	0	0	0	0	0	0
Connor O'Mara	Akron	Jan. 14, 2017	Palmyra Range	96	96	99	100	92	88	571	23	95	98	94	95	95	94	571	25
Marlee Reynolds	Akron	Jan. 14, 2017	Palmyra Range	0	0	0	0	0	0	0	0	0	0	0	0	0	0	0	0
Sean Roehrs	Akron	Jan. 14, 2017	Palmyra Range	0	0	0	0	0	0	0	0	0	0	0	0	0	0	0	0
Zach Strohl	Akron	Jan. 14, 2017	Palmyra Range	96	95	100	98	93	91	573	27	97	96	99	98	99	98	587	40
Cierra Terrizzi	Akron	Jan. 14, 2017	Palmyra Range	95	94	97	97	91	91	565	28	92	97	94	97	97	98	575	27
Soren Butler	Alaska Fairbanks	Jan. 14, 2017	Palmyra Range	93	99	97	99	92	96	576	25	96	99	97	98	97	98	585	37
Liam Eberhart	Alaska Fairbanks	Jan. 14, 2017	Palmyra Range	0	0	0	0	0	0	0	0	0	0	0	0	0	0	0	0
Amy Gentry	Alaska Fairbanks	Jan. 14, 2017	Palmyra Range	98	95	100	99	96	90	578	29	98	98	98	98	97	98	587	30
Luke Johnson	Alaska Fairbanks	Jan. 14, 2017	Palmyra Range	97	94	96	99	94	96	576	29	100	98	98	97	98	97	588	38
Sagen Maddalena	Alaska Fairbanks	Jan. 14, 2017	Palmyra Range	99	96	99	99	95	94	582	33	99	99	97	99	100	100	594	42
Grace Nelson	Alaska Fairbanks	Jan. 14, 2017	Palmyra Range	95	95	100	95	96	96	577	25	99	96	93	94	95	95	572	27
JT Schnering	Alaska Fairbanks	Jan. 14, 2017	Palmyra Range	95	97	95	96	90	88	561	21	98	94	95	97	96	97	577	35
Robert Scott	Alaska Fairbanks	Jan. 14, 2017	Palmyra Range	89	89	96	94	97	91	556	21	98	96	96	96	99	98	583	39
Nathan Taylor	Alaska Fairbanks	Jan. 14, 2017	Palmyra Range	0	0	0	0	0	0	0	0	0	0	0	0	0	0	0	0
Nathan Brewer	Army	Jan. 14, 2017	Palmyra Range	95	90	98	99	96	95	573	24	99	96	96	98	97	97	583	45
Emiliano Concha-Toro	Army	Jan. 14, 2017	Palmyra Range	95	95	98	100	91	91	570	24	96	97	94	94	98	99	578	27
Ethan Cook	Army	Jan. 14, 2017	Palmyra Range	91	92	99	100	88	95	565	24	95	96	92	95	92	96	566	21
Danielle Cuomo	Army	Jan. 14, 2017	Palmyra Range	96	98	98	98	96	93	579	27	97	99	98	98	99	96	587	38
Maggie Ehmann	Army	Jan. 14, 2017	Palmyra Range	88	92	95	95	86	90	546	11	99	95	97	96	95	97	579	30
Maddy Erikson	Army	Jan. 14, 2017	Palmyra Range	92	91	97	99	92	94	565	22	97	99	98	97	98	99	588	36
Mike Garner	Army	Jan. 14, 2017	Palmyra Range	95	97	92	98	92	94	568	22	94	95	93	91	91	98	562	23
Nick Kanellis	Army	Jan. 14, 2017	Palmyra Range	94	87	96	98	93	91	559	22	97	95	96	97	97	98	580	30
Marvin Lewis	Army	Jan. 14, 2017	Palmyra Range	96	95	97	99	97	95	579	32	100	99	96	99	100	99	593	42
Rhianna Lichtenthal	Army	Jan. 14, 2017	Palmyra Range	91	89	99	96	90	87	552	18	96	98	98	96	98	94	580	29
Libby Mostert	Army	Jan. 14, 2017	Palmyra Range	89	94	98	97	84	89	551	17	98	96	94	97	98	94	577	30
Sarah Nakata	Army	Jan. 14, 2017	Palmyra Range	0	0	0	0	0	0	0	0	0	0	0	0	0	0	0	0
Payne Nunn	Army	Jan. 14, 2017	Palmyra Range	94	97	99	97	92	93	572	24	97	97	98	97	98	97	584	39
Allen Solida	Army	Jan. 14, 2017	Palmyra Range	97	92	97	98	93	91	568	27	94	98	98	99	95	93	577	28
Andrew Solomonides	Army	Jan. 14, 2017	Palmyra Range	90	96	97	97	90	92	562	21	95	93	91	96	95	99	569	24
Melissa Brizzi	Coast Guard	Jan. 14, 2017	Palmyra Range	91	85	91	97	77	77	518	9	88	80	88	85	83	88	512	8
Joseph Busching	Coast Guard	Jan. 14, 2017	Palmyra Range	0	0	0	0	0	0	0	0	88	90	80	86	86	90	520	5
Jacob Dupree	Coast Guard	Jan. 14, 2017	Palmyra Range	86	92	90	94	85	84	531	10	92	96	89	89	94	90	550	17
Randall Ford	Coast Guard	Jan. 14, 2017	Palmyra Range	93	92	97	99	91	89	561	21	92	90	93	94	93	89	551	19
Marshall Grant	Coast Guard	Jan. 14, 2017	Palmyra Range	91	77	93	95	86	79	521	13	90	92	90	87	93	91	543	13
Alexandria Harrington	Coast Guard	Jan. 14, 2017	Palmyra Range	0	0	0	0	0	0	0	0	0	0	0	0	0	0	0	0
Anthony Lee	Coast Guard	Jan. 14, 2017	Palmyra Range	0	0	0	0	0	0	0	0	0	0	0	0	0	0	0	0
Dylan Lorence	Coast Guard	Jan. 14, 2017	Palmyra Range	94	88	94	99	75	79	529	16	85	90	92	91	92	86	536	8
Kaden Nichols	Coast Guard	Jan. 14, 2017	Palmyra Range	0	0	0	0	0	0	0	0	88	77	86	84	89	83	507	10
Nicholas Paisker	Coast Guard	Jan. 14, 2017	Palmyra Range	93	86	94	93	85	91	542	12	93	97	94	96	98	96	574	30
Paul Raynolds	Coast Guard	Jan. 14, 2017	Palmyra Range	0	0	0	0	0	0	0	0	0	0	0	0	0	0	0	0
David Rose	Coast Guard	Jan. 14, 2017	Palmyra Range	87	85	93	94	66	65	490	8	0	0	0	0	0	0	0	0
Alaric Stone	Coast Guard	Jan. 14, 2017	Palmyra Range	0	0	0	0	0	0	0	0	85	89	86	89	90	92	531	12
Nyjah Turner	Coast Guard	Jan. 14, 2017	Palmyra Range	86	89	95	91	81	85	527	10	92	86	90	85	91	88	532	5
Seth Baker	Morehead St.	Jan. 14, 2017	Palmyra Range	95	94	98	98	93	91	569	23	97	95	96	95	95	95	573	28
Brandon Bryer	Morehead St.	Jan. 14, 2017	Palmyra Range	96	93	99	99	90	88	565	24	95	97	99	100	97	97	585	38
Siarra Crum	Morehead St.	Jan. 14, 2017	Palmyra Range	90	88	92	90	87	93	540	15	95	94	98	97	96	97	577	29
Sarah Fink	Morehead St.	Jan. 14, 2017	Palmyra Range	93	95	96	95	91	91	561	18	93	98	98	96	97	93	575	26
Joe Fischer	Morehead St.	Jan. 14, 2017	Palmyra Range	96	97	99	98	90	90	570	31	97	95	96	96	95	96	575	32
Dan Hall	Morehead St.	Jan. 14, 2017	Palmyra Range	96	94	97	97	77	88	549	20	93	95	94	96	91	89	558	18
Jesse Moyer	Morehead St.	Jan. 14, 2017	Palmyra Range	95	94	93	93	89	91	555	17	93	97	98	100	98	98	584	35
Alexa Potts	Morehead St.	Jan. 14, 2017	Palmyra Range	96	95	99	97	91	91	569	23	97	96	96	94	96	97	576	33
Karly Potts	Morehead St.	Jan. 14, 2017	Palmyra Range	94	97	99	97	89	92	568	24	94	99	95	99	96	97	580	33
Melanie West	Morehead St.	Jan. 14, 2017	Palmyra Range	88	93	99	99	94	92	565	21	93	98	95	93	95	93	567	22
Haley Wilson	Morehead St.	Jan. 14, 2017	Palmyra Range	0	0	0	0	0	0	0	0	0	0	0	0	0	0	0	0
Lucas Figi	Navy	Jan. 14, 2017	Palmyra Range	87	96	100	98	92	86	559	23	96	92	93	95	94	95	565	20
Maggie Guetersloh	Navy	Jan. 14, 2017	Palmyra Range	0	0	0	0	0	0	0	0	0	0	0	0	0	0	0	0
Amy Hammer	Navy	Jan. 14, 2017	Palmyra Range	0	0	0	0	0	0	0	0	0	0	0	0	0	0	0	0
Daniel Jonas	Navy	Jan. 14, 2017	Palmyra Range	96	95	99	100	93	95	578	29	95	95	97	97	94	99	577	29
Kestrel Kuhne	Navy	Jan. 14, 2017	Palmyra Range	98	95	98	100	90	90	571	30	98	100	98	99	98	98	591	42
Alex Muzzioli	Navy	Jan. 14, 2017	Palmyra Range	96	98	99	100	93	92	578	34	93	95	96	96	98	96	574	28
Brandon Pippin	Navy	Jan. 14, 2017	Palmyra Range	0	0	0	0	0	0	0	0	95	97	93	94	99	95	573	23
Nash Richardson	Navy	Jan. 14, 2017	Palmyra Range	94	94	97	99	87	89	560	21	96	95	96	93	96	98	574	27
Thomas Sarant	Navy	Jan. 14, 2017	Palmyra Range	93	92	99	99	94	95	572	25	97	95	97	98	96	100	583	37
Josh Watson	Navy	Jan. 14, 2017	Palmyra Range	95	94	100	100	95	93	577	27	97	97	99	96	97	99	585	39
Hayley Carroll	Ole Miss	Jan. 14, 2017	Palmyra Range	96	94	99	99	89	94	571	25	96	97	96	100	97	99	585	34
Harley Gardner	Ole Miss	Jan. 14, 2017	Palmyra Range	95	93	99	99	92	94	572	31	99	96	99	100	98	99	591	39
Jess Haig	Ole Miss	Jan. 14, 2017	Palmyra Range	96	93	99	97	92	93	570	24	97	98	99	100	99	96	589	41
Alana Kelly	Ole Miss	Jan. 14, 2017	Palmyra Range	96	92	98	98	92	90	566	24	99	94	98	98	95	95	579	31
Randi Loudin	Ole Miss	Jan. 14, 2017	Palmyra Range	0	0	0	0	0	0	0	0	0	0	0	0	0	0	0	0
Marina Noble	Ole Miss	Jan. 14, 2017	Palmyra Range	0	0	0	0	0	0	0	0	0	0	0	0	0	0	0	0
Samantha Sandifer	Ole Miss	Jan. 14, 2017	Palmyra Range	0	0	0	0	0	0	0	0	0	0	0	0	0	0	0	0
Kristyn Trump	Ole Miss	Jan. 14, 2017	Palmyra Range	91	92	96	100	92	92	563	25	97	96	96	95	97	93	574	30
Jillian Tyler	Ole Miss	Jan. 14, 2017	Palmyra Range	0	0	0	0	0	0	0	0	0	0	0	0	0	0	0	0
Ali Weisz	Ole Miss	Jan. 14, 2017	Palmyra Range	91	93	97	97	94	95	567	24	99	98	97	98	99	97	588	39
Spencer Brandon	Air Force	Jan. 14, 2017	Air Force	91	91	97	97	93	91	560	0	97	99	100	98	98	95	587	0
Spencer Cap	Air Force	Jan. 14, 2017	Air Force	95	95	97	98	92	90	567	0	99	98	99	99	100	99	594	0
Kyle Cox	Air Force	Jan. 14, 2017	Air Force	0	0	0	0	0	0	0	0	93	97	94	96	95	94	569	0
Ryan Jacobs	Air Force	Jan. 14, 2017	Air Force	98	94	97	98	91	93	571	0	97	98	98	100	98	97	588	0
Noah Kwock	Air Force	Jan. 14, 2017	Air Force	0	0	0	0	0	0	0	0	97	93	96	91	97	98	572	0
Nick Learn	Air Force	Jan. 14, 2017	Air Force	97	93	98	97	92	93	570	0	95	98	96	100	98	99	586	0
Logan Ogden	Air Force	Jan. 14, 2017	Air Force	97	95	99	100	96	92	579	0	98	98	100	97	99	96	588	0
Mary Simonton	Air Force	Jan. 14, 2017	Air Force	0	0	0	0	0	0	0	0	0	0	0	0	0	0	0	0
Anna Weilbacher	Air Force	Jan. 14, 2017	Air Force	99	100	99	99	97	98	592	0	98	98	98	99	100	99	592	0
Deanna Binnie	Ohio State	Jan. 14, 2017	Air Force	0	0	0	0	0	0	0	0	0	0	0	0	0	0	0	0
Josh Black	Ohio State	Jan. 14, 2017	Air Force	94	90	96	98	93	97	568	0	98	97	97	99	96	98	585	0
Jacob Buchanan	Ohio State	Jan. 14, 2017	Air Force	95	92	98	97	90	91	563	0	100	100	99	97	100	99	595	0
Drew Cheezum	Ohio State	Jan. 14, 2017	Air Force	98	99	98	98	92	94	579	0	98	98	99	98	99	99	591	0
Anthony Cuozzo	Ohio State	Jan. 14, 2017	Air Force	94	97	99	99	90	89	568	0	97	100	98	98	97	98	588	0
Kendal Elder	Ohio State	Jan. 14, 2017	Air Force	0	0	0	0	0	0	0	0	0	0	0	0	0	0	0	0
Alli Kissell	Ohio State	Jan. 14, 2017	Air Force	0	0	0	0	0	0	0	0	0	0	0	0	0	0	0	0
Mark Matheny	Ohio State	Jan. 14, 2017	Air Force	95	97	100	99	97	96	584	0	100	97	99	100	98	99	593	0
Patrick Sardo	Ohio State	Jan. 14, 2017	Air Force	0	0	0	0	0	0	0	0	0	0	0	0	0	0	0	0
Michael Steinel	Ohio State	Jan. 14, 2017	Air Force	98	96	97	97	86	95	569	0	98	97	98	98	99	97	587	0
Chrissy Thomas	Ohio State	Jan. 14, 2017	Air Force	0	0	0	0	0	0	0	0	0	0	0	0	0	0	0	0
Rhiann Travis	Ohio State	Jan. 14, 2017	Air Force	96	94	96	96	88	93	563	0	98	100	99	100	100	98	595	0
Bailey Urbach	Ohio State	Jan. 14, 2017	Air Force	0	0	0	0	0	0	0	0	0	0	0	0	0	0	0	0
Brendan Whitaker	Ohio State	Jan. 14, 2017	Air Force	0	0	0	0	0	0	0	0	0	0	0	0	0	0	0	0
Quintin Wotring	Ohio State	Jan. 14, 2017	Air Force	0	0	0	0	0	0	0	0	0	0	0	0	0	0	0	0
Hunter Behrends	Jacksonville St.	Jan. 14, 2017	Air Force	0	0	0	0	0	0	0	0	0	0	0	0	0	0	0	0
Austin Cock	Jacksonville St.	Jan. 14, 2017	Air Force	93	94	92	100	91	88	558	0	100	95	95	97	95	97	579	0
Anika Corsi	Jacksonville St.	Jan. 14, 2017	Air Force	0	0	0	0	0	0	0	0	0	0	0	0	0	0	0	0
Trace Haynes	Jacksonville St.	Jan. 14, 2017	Air Force	96	96	99	100	91	96	578	0	92	97	95	95	96	95	570	0
Brandon Henson	Jacksonville St.	Jan. 14, 2017	Air Force	0	0	0	0	0	0	0	0	0	0	0	0	0	0	0	0
Brandon Muske	Jacksonville St.	Jan. 14, 2017	Air Force	94	98	97	96	97	95	577	0	99	96	100	100	97	99	591	0
Kyle Ordille	Jacksonville St.	Jan. 14, 2017	Air Force	0	0	0	0	0	0	0	0	0	0	0	0	0	0	0	0
Carleigh Peters	Jacksonville St.	Jan. 14, 2017	Air Force	0	0	0	0	0	0	0	0	0	0	0	0	0	0	0	0
Garrett Rabel	Jacksonville St.	Jan. 14, 2017	Air Force	97	99	97	99	92	91	575	0	98	98	94	98	94	98	580	0
Tyler Ramos	Jacksonville St.	Jan. 14, 2017	Air Force	0	0	0	0	0	0	0	0	0	0	0	0	0	0	0	0
Mekenna Richardson	Jacksonville St.	Jan. 14, 2017	Air Force	96	97	97	99	92	92	573	0	99	99	98	96	99	94	585	0
Carter Santrock	Jacksonville St.	Jan. 14, 2017	Air Force	95	96	98	98	94	93	574	0	97	97	99	99	98	98	588	0
Zach Schmidt	Jacksonville St.	Jan. 14, 2017	Air Force	91	95	97	99	89	93	564	0	95	97	99	94	93	97	575	0
David Sink	Jacksonville St.	Jan. 14, 2017	Air Force	96	96	98	94	89	93	566	0	98	94	95	95	98	96	576	0
Billy Azzinaro	Kentucky	Jan. 14, 2017	Ole Miss	91	94	98	99	95	95	572	26	98	98	100	97	100	97	590	44
Jenna Bethea	Kentucky	Jan. 14, 2017	Ole Miss	0	0	0	0	0	0	0	0	0	0	0	0	0	0	0	0
Hanna Carr	Kentucky	Jan. 14, 2017	Ole Miss	97	94	99	99	92	98	579	29	95	99	100	96	99	96	585	29
Morgan Duerr	Kentucky	Jan. 14, 2017	Ole Miss	0	0	0	0	0	0	0	0	0	0	0	0	0	0	0	0
Ian Foos	Kentucky	Jan. 14, 2017	Ole Miss	0	0	0	0	0	0	0	0	0	0	0	0	0	0	0	0
Carmen Fry	Kentucky	Jan. 14, 2017	Ole Miss	0	0	0	0	0	0	0	0	0	0	0	0	0	0	0	0
Heather Kirby	Kentucky	Jan. 14, 2017	Ole Miss	96	95	99	99	95	96	580	33	100	99	99	97	98	99	592	43
Sonya May	Kentucky	Jan. 14, 2017	Ole Miss	92	94	97	98	95	97	573	23	100	97	99	98	98	98	590	41
Andrew Miller	Kentucky	Jan. 14, 2017	Ole Miss	0	0	0	0	0	0	0	0	0	0	0	0	0	0	0	0
Cathryn Papasodora	Kentucky	Jan. 14, 2017	Ole Miss	0	0	0	0	0	0	0	0	0	0	0	0	0	0	0	0
Jason Scharbel	Kentucky	Jan. 14, 2017	Ole Miss	99	99	99	96	92	96	581	30	99	94	96	100	97	98	584	34
Jason Spaude	Kentucky	Jan. 14, 2017	Ole Miss	96	98	96	98	94	93	575	23	95	98	98	98	99	97	585	40
Bobby Broadstreet	Murray St.	Jan. 14, 2017	Ole Miss	98	99	100	100	96	95	588	38	100	100	99	100	100	98	597	53
Meike Drewell	Murray St.	Jan. 14, 2017	Ole Miss	96	98	97	99	94	92	576	21	98	97	98	98	98	97	586	36
Ben Estes	Murray St.	Jan. 14, 2017	Ole Miss	96	99	99	97	95	95	581	24	98	95	99	97	97	96	582	31
Shelby Huber	Murray St.	Jan. 14, 2017	Ole Miss	95	93	98	95	94	95	570	23	99	97	99	98	98	99	590	39
Mackenzie Martin	Murray St.	Jan. 14, 2017	Ole Miss	97	96	99	99	98	93	582	28	98	98	98	100	98	97	589	39
Ivan Roe	Murray St.	Jan. 14, 2017	Ole Miss	99	97	100	100	98	95	589	35	99	100	99	100	98	98	594	49
Barbara Schlapfer	Murray St.	Jan. 14, 2017	Ole Miss	99	97	99	100	95	92	582	28	96	98	99	97	100	99	589	45
Alathea Sellars	Murray St.	Jan. 14, 2017	Ole Miss	97	94	98	97	95	91	572	20	99	99	98	99	100	99	594	43
Eric Sloan	Murray St.	Jan. 14, 2017	Ole Miss	0	0	0	0	0	0	0	0	0	0	0	0	0	0	0	0
Hayley Carroll	Ole Miss	Jan. 14, 2017	Ole Miss	94	92	99	97	94	88	564	25	95	94	96	97	96	97	575	25
Harley Gardner	Ole Miss	Jan. 14, 2017	Ole Miss	94	90	100	100	94	93	571	21	97	99	98	98	96	99	587	41
Jess Haig	Ole Miss	Jan. 14, 2017	Ole Miss	95	96	100	97	94	92	574	21	97	98	97	96	99	98	585	37
Alana Kelly	Ole Miss	Jan. 14, 2017	Ole Miss	94	94	93	98	91	90	560	15	97	98	95	96	95	96	577	29
Randi Loudin	Ole Miss	Jan. 14, 2017	Ole Miss	90	89	100	100	86	93	558	22	95	97	97	96	96	93	574	27
Marina Noble	Ole Miss	Jan. 14, 2017	Ole Miss	0	0	0	0	0	0	0	0	0	0	0	0	0	0	0	0
Samantha Sandifer	Ole Miss	Jan. 14, 2017	Ole Miss	94	91	97	93	87	91	553	10	96	97	97	95	94	96	575	25
Kristyn Trump	Ole Miss	Jan. 14, 2017	Ole Miss	91	96	99	98	91	93	568	24	97	98	96	98	99	96	584	32
Jillian Tyler	Ole Miss	Jan. 14, 2017	Ole Miss	93	88	98	98	95	91	563	19	99	95	94	97	96	97	578	33
Ali Weisz	Ole Miss	Jan. 14, 2017	Ole Miss	95	92	95	97	96	95	570	20	99	100	97	100	100	99	595	50
Nathan Brewer	Army	Jan. 14, 2017	Army	98	94	96	100	94	94	576	24	96	95	96	97	96	96	576	30
Emiliano Concha-Toro	Army	Jan. 14, 2017	Army	93	98	97	100	95	94	577	30	97	99	96	98	95	97	582	38
Ethan Cook	Army	Jan. 14, 2017	Army	94	95	99	99	88	91	566	17	97	95	97	94	93	91	567	20
Danielle Cuomo	Army	Jan. 14, 2017	Army	96	96	99	98	95	95	579	27	97	100	97	99	97	98	588	39
Maggie Ehmann	Army	Jan. 14, 2017	Army	92	91	99	98	95	92	567	20	96	100	98	99	99	98	590	38
Maddy Erikson	Army	Jan. 14, 2017	Army	92	95	98	94	94	91	564	21	96	97	100	97	98	99	587	35
Mike Garner	Army	Jan. 14, 2017	Army	93	95	100	98	91	93	570	20	96	97	98	96	96	97	580	33
Nick Kanellis	Army	Jan. 14, 2017	Army	92	92	97	94	90	89	554	16	99	93	93	98	98	97	578	31
Marvin Lewis	Army	Jan. 14, 2017	Army	94	96	100	100	93	98	581	22	97	100	98	99	99	97	590	48
Rhianna Lichtenthal	Army	Jan. 14, 2017	Army	90	91	96	98	92	91	558	14	98	97	98	95	97	97	582	33
Libby Mostert	Army	Jan. 14, 2017	Army	98	88	96	97	92	87	558	16	96	96	99	95	96	97	579	32
Sarah Nakata	Army	Jan. 14, 2017	Army	0	0	0	0	0	0	0	0	0	0	0	0	0	0	0	0
Payne Nunn	Army	Jan. 14, 2017	Army	97	97	100	100	92	97	583	25	97	96	97	99	99	96	584	43
Allen Solida	Army	Jan. 14, 2017	Army	96	94	100	90	93	94	567	27	99	95	94	98	96	100	582	38
Andrew Solomonides	Army	Jan. 14, 2017	Army	87	92	100	96	90	93	558	16	93	97	96	98	95	97	576	26
Zach Eisenberg	North Carolina St.	Jan. 14, 2017	Army	95	89	98	98	91	94	565	19	94	97	97	99	99	97	583	34
Caitlyn Ford	North Carolina St.	Jan. 14, 2017	Army	94	95	96	95	95	95	570	19	98	99	100	97	98	100	592	44
Sarah Hickey	North Carolina St.	Jan. 14, 2017	Army	0	0	0	0	0	0	0	0	0	0	0	0	0	0	0	0
Lucas Kozeniesky	North Carolina St.	Jan. 14, 2017	Army	96	96	99	98	97	96	582	23	99	99	100	98	100	99	595	46
Tyler Lefebvre	North Carolina St.	Jan. 14, 2017	Army	89	91	89	87	85	89	530	10	94	97	97	97	89	96	570	26
Will Marciniak	North Carolina St.	Jan. 14, 2017	Army	95	98	97	97	95	95	577	26	95	98	97	96	93	96	575	27
Derya Pekari	North Carolina St.	Jan. 14, 2017	Army	92	94	96	95	94	96	567	22	97	99	97	96	96	97	582	33
Lauren Phillips	North Carolina St.	Jan. 14, 2017	Army	98	97	99	96	96	98	584	27	100	99	99	97	99	97	591	46
Claire Spina	North Carolina St.	Jan. 14, 2017	Army	89	94	94	94	96	91	558	13	95	94	96	95	94	98	572	20
Cullen Wargo	North Carolina St.	Jan. 14, 2017	Army	0	0	0	0	0	0	0	0	0	0	0	0	0	0	0	0
George Williams	North Carolina St.	Jan. 14, 2017	Army	90	85	93	95	90	84	537	10	94	93	92	91	94	94	558	17
Claire Zanti	North Carolina St.	Jan. 14, 2017	Army	95	93	96	99	91	94	568	19	98	96	98	97	98	96	583	35
Zach Eisenberg	North Carolina St.	Jan. 15, 2017	Army	92	97	98	100	92	90	569	23	96	98	96	94	95	98	577	29
Caitlyn Ford	North Carolina St.	Jan. 15, 2017	Army	95	94	98	100	95	95	577	27	96	97	99	96	99	99	586	35
Sarah Hickey	North Carolina St.	Jan. 15, 2017	Army	0	0	0	0	0	0	0	0	0	0	0	0	0	0	0	0
Lucas Kozeniesky	North Carolina St.	Jan. 15, 2017	Army	97	96	96	96	94	95	574	25	100	100	100	100	99	98	597	41
Tyler Lefebvre	North Carolina St.	Jan. 15, 2017	Army	89	86	93	96	88	91	543	12	97	97	97	93	90	95	569	20
Will Marciniak	North Carolina St.	Jan. 15, 2017	Army	99	97	97	98	91	96	578	24	98	97	96	97	93	95	576	28
Derya Pekari	North Carolina St.	Jan. 15, 2017	Army	95	95	98	100	94	91	573	25	97	96	98	94	93	95	573	29
Lauren Phillips	North Carolina St.	Jan. 15, 2017	Army	98	98	98	100	97	95	586	31	100	98	100	99	97	96	590	41
Claire Spina	North Carolina St.	Jan. 15, 2017	Army	89	93	98	98	92	94	564	18	96	96	98	93	96	95	574	31
Cullen Wargo	North Carolina St.	Jan. 15, 2017	Army	0	0	0	0	0	0	0	0	0	0	0	0	0	0	0	0
George Williams	North Carolina St.	Jan. 15, 2017	Army	88	97	99	96	87	86	553	20	95	95	94	94	95	97	570	21
Claire Zanti	North Carolina St.	Jan. 15, 2017	Army	94	94	96	98	93	96	571	20	97	97	98	98	95	96	581	29
Katie Brown	Nebraska	Jan. 15, 2017	Army	0	0	0	0	0	0	0	0	0	0	0	0	0	0	0	0
Jaycee Carter	Nebraska	Jan. 15, 2017	Army	95	99	100	97	91	97	579	32	98	97	99	99	97	94	584	40
Dacotah Faught	Nebraska	Jan. 15, 2017	Army	94	96	98	99	93	94	574	23	100	100	98	98	99	100	595	42
Kayla Gadeken	Nebraska	Jan. 15, 2017	Army	94	95	97	99	89	88	562	18	98	98	87	97	96	98	574	33
Maddie Korthas	Nebraska	Jan. 15, 2017	Army	0	0	0	0	0	0	0	0	0	0	0	0	0	0	0	0
Rachel Martin	Nebraska	Jan. 15, 2017	Army	96	96	100	97	93	94	576	21	98	99	99	99	100	99	594	45
Jordan Miller	Nebraska	Jan. 15, 2017	Army	0	0	0	0	0	0	0	0	0	0	0	0	0	0	0	0
Samantha Peterson	Nebraska	Jan. 15, 2017	Army	99	97	98	100	95	92	581	31	97	98	99	100	99	97	590	41
Nina Radulovic	Nebraska	Jan. 15, 2017	Army	96	97	98	98	90	92	571	20	100	96	100	97	99	97	589	38
Sarah Sutton	Nebraska	Jan. 15, 2017	Army	95	96	94	95	93	91	564	18	96	92	96	95	94	97	570	28
Hannah Virga	Nebraska	Jan. 15, 2017	Army	0	0	0	0	0	0	0	0	0	0	0	0	0	0	0	0
Rachel Yager	Nebraska	Jan. 15, 2017	Army	96	98	94	96	93	93	570	18	94	95	98	96	95	96	574	26
Billy Azzinaro	Kentucky	Jan. 15, 2017	Ole Miss	96	96	98	100	90	92	572	0	99	100	97	97	97	100	590	0
Jenna Bethea	Kentucky	Jan. 15, 2017	Ole Miss	0	0	0	0	0	0	0	0	0	0	0	0	0	0	0	0
Hanna Carr	Kentucky	Jan. 15, 2017	Ole Miss	94	98	100	100	92	93	577	0	98	99	96	97	98	98	586	0
Morgan Duerr	Kentucky	Jan. 15, 2017	Ole Miss	0	0	0	0	0	0	0	0	0	0	0	0	0	0	0	0
Ian Foos	Kentucky	Jan. 15, 2017	Ole Miss	0	0	0	0	0	0	0	0	0	0	0	0	0	0	0	0
Carmen Fry	Kentucky	Jan. 15, 2017	Ole Miss	0	0	0	0	0	0	0	0	0	0	0	0	0	0	0	0
Heather Kirby	Kentucky	Jan. 15, 2017	Ole Miss	91	98	100	99	94	94	576	0	97	100	100	100	100	99	596	0
Sonya May	Kentucky	Jan. 15, 2017	Ole Miss	95	96	98	97	92	95	573	0	98	99	98	98	99	98	590	0
Andrew Miller	Kentucky	Jan. 15, 2017	Ole Miss	0	0	0	0	0	0	0	0	0	0	0	0	0	0	0	0
Cathryn Papasodora	Kentucky	Jan. 15, 2017	Ole Miss	0	0	0	0	0	0	0	0	0	0	0	0	0	0	0	0
Jason Scharbel	Kentucky	Jan. 15, 2017	Ole Miss	97	96	99	99	92	95	578	0	99	97	99	99	98	93	585	0
Jason Spaude	Kentucky	Jan. 15, 2017	Ole Miss	95	97	97	98	91	93	571	0	98	100	96	97	95	99	585	0
Jack Berhorst	Memphis	Jan. 15, 2017	Ole Miss	0	0	0	0	0	0	0	0	0	0	0	0	0	0	0	0
Haylea Broughton	Memphis	Jan. 15, 2017	Ole Miss	93	93	98	97	92	94	567	0	97	99	97	100	97	96	586	0
Levi Clark	Memphis	Jan. 15, 2017	Ole Miss	0	0	0	0	0	0	0	0	0	0	0	0	0	0	0	0
Leighton Dempster	Memphis	Jan. 15, 2017	Ole Miss	92	91	98	99	91	90	561	0	96	99	98	99	97	96	585	0
Makennon Doran	Memphis	Jan. 15, 2017	Ole Miss	98	97	97	99	94	92	577	0	97	99	92	97	94	95	574	0
Amberlie Ezell	Memphis	Jan. 15, 2017	Ole Miss	95	92	93	95	92	89	556	0	98	97	98	98	99	99	589	0
Amy Fister	Memphis	Jan. 15, 2017	Ole Miss	0	0	0	0	0	0	0	0	0	0	0	0	0	0	0	0
Eli Rischling	Memphis	Jan. 15, 2017	Ole Miss	97	94	96	100	92	84	563	0	96	94	97	94	93	95	569	0
Abby Votava	Memphis	Jan. 15, 2017	Ole Miss	92	92	96	96	93	94	563	0	98	94	99	97	97	94	579	0
Nathan Brewer	Army	Jan. 16, 2017	Army	97	97	98	96	92	88	568	26	99	97	98	98	96	98	586	38
Emiliano Concha-Toro	Army	Jan. 16, 2017	Army	95	92	98	100	97	91	573	25	96	100	99	98	96	97	586	41
Ethan Cook	Army	Jan. 16, 2017	Army	98	93	97	98	90	93	569	26	96	96	92	97	95	96	572	27
Danielle Cuomo	Army	Jan. 16, 2017	Army	94	91	99	98	95	92	569	17	98	98	97	100	98	98	589	38
Maggie Ehmann	Army	Jan. 16, 2017	Army	96	88	97	99	93	92	565	18	94	96	97	97	98	96	578	32
Maddy Erikson	Army	Jan. 16, 2017	Army	93	91	94	99	96	91	564	23	96	98	98	96	97	97	582	36
Mike Garner	Army	Jan. 16, 2017	Army	96	96	97	98	88	88	563	22	92	93	98	94	98	96	571	24
Nick Kanellis	Army	Jan. 16, 2017	Army	93	93	97	97	89	90	559	19	99	96	100	93	93	94	575	34
Marvin Lewis	Army	Jan. 16, 2017	Army	97	94	100	97	98	96	582	24	99	96	100	97	94	99	585	40
Rhianna Lichtenthal	Army	Jan. 16, 2017	Army	91	93	99	95	95	93	566	18	97	94	94	96	94	98	573	28
Libby Mostert	Army	Jan. 16, 2017	Army	92	95	99	97	96	93	572	23	96	95	96	96	98	99	580	29
Sarah Nakata	Army	Jan. 16, 2017	Army	0	0	0	0	0	0	0	0	0	0	0	0	0	0	0	0
Payne Nunn	Army	Jan. 16, 2017	Army	96	96	100	98	97	95	582	25	98	98	97	98	98	97	586	38
Allen Solida	Army	Jan. 16, 2017	Army	97	97	97	98	86	88	563	21	98	96	97	96	98	99	584	39
Andrew Solomonides	Army	Jan. 16, 2017	Army	93	94	95	99	95	90	566	17	96	97	94	97	96	95	575	30
Katie Brown	Nebraska	Jan. 16, 2017	Army	0	0	0	0	0	0	0	0	0	0	0	0	0	0	0	0
Jaycee Carter	Nebraska	Jan. 16, 2017	Army	91	93	98	97	96	93	568	21	98	98	97	97	98	98	586	37
Dacotah Faught	Nebraska	Jan. 16, 2017	Army	96	93	98	100	97	93	577	30	99	100	96	99	100	99	593	45
Kayla Gadeken	Nebraska	Jan. 16, 2017	Army	97	97	100	98	89	92	573	28	97	91	96	97	97	99	577	30
Maddie Korthas	Nebraska	Jan. 16, 2017	Army	0	0	0	0	0	0	0	0	0	0	0	0	0	0	0	0
Rachel Martin	Nebraska	Jan. 16, 2017	Army	97	97	97	89	90	98	568	26	99	100	97	99	99	100	594	46
Jordan Miller	Nebraska	Jan. 16, 2017	Army	0	0	0	0	0	0	0	0	0	0	0	0	0	0	0	0
Samantha Peterson	Nebraska	Jan. 16, 2017	Army	96	95	99	97	93	98	578	27	98	98	96	95	96	95	578	27
Nina Radulovic	Nebraska	Jan. 16, 2017	Army	97	98	100	99	93	89	576	34	99	97	98	100	100	99	593	44
Sarah Sutton	Nebraska	Jan. 16, 2017	Army	93	92	95	98	87	89	554	19	95	97	93	96	96	96	573	25
Hannah Virga	Nebraska	Jan. 16, 2017	Army	0	0	0	0	0	0	0	0	0	0	0	0	0	0	0	0
Rachel Yager	Nebraska	Jan. 16, 2017	Army	98	97	98	98	93	91	575	28	92	97	93	94	98	97	571	26
Deanna Binnie	Ohio State	Jan. 16, 2017	Air Force	0	0	0	0	0	0	0	0	0	0	0	0	0	0	0	0
Josh Black	Ohio State	Jan. 16, 2017	Air Force	95	92	98	99	96	95	575	0	98	100	100	97	99	97	591	0
Jacob Buchanan	Ohio State	Jan. 16, 2017	Air Force	96	90	97	99	90	92	564	0	99	96	98	98	97	95	583	0
Drew Cheezum	Ohio State	Jan. 16, 2017	Air Force	97	96	100	99	90	95	577	0	99	99	98	100	99	99	594	0
Anthony Cuozzo	Ohio State	Jan. 16, 2017	Air Force	98	97	98	99	90	96	578	0	98	98	96	100	98	96	586	0
Kendal Elder	Ohio State	Jan. 16, 2017	Air Force	0	0	0	0	0	0	0	0	0	0	0	0	0	0	0	0
Alli Kissell	Ohio State	Jan. 16, 2017	Air Force	0	0	0	0	0	0	0	0	0	0	0	0	0	0	0	0
Mark Matheny	Ohio State	Jan. 16, 2017	Air Force	97	96	99	99	95	93	579	0	94	99	99	97	100	100	589	0
Patrick Sardo	Ohio State	Jan. 16, 2017	Air Force	0	0	0	0	0	0	0	0	0	0	0	0	0	0	0	0
Michael Steinel	Ohio State	Jan. 16, 2017	Air Force	97	94	100	98	92	91	572	0	97	99	98	99	97	100	590	0
Chrissy Thomas	Ohio State	Jan. 16, 2017	Air Force	0	0	0	0	0	0	0	0	0	0	0	0	0	0	0	0
Rhiann Travis	Ohio State	Jan. 16, 2017	Air Force	95	97	99	98	98	90	577	0	97	98	98	97	99	98	587	0
Bailey Urbach	Ohio State	Jan. 16, 2017	Air Force	0	0	0	0	0	0	0	0	0	0	0	0	0	0	0	0
Brendan Whitaker	Ohio State	Jan. 16, 2017	Air Force	0	0	0	0	0	0	0	0	0	0	0	0	0	0	0	0
Quintin Wotring	Ohio State	Jan. 16, 2017	Air Force	0	0	0	0	0	0	0	0	0	0	0	0	0	0	0	0
Hunter Behrends	Jacksonville St.	Jan. 16, 2017	Air Force	0	0	0	0	0	0	0	0	0	0	0	0	0	0	0	0
Austin Cock	Jacksonville St.	Jan. 16, 2017	Air Force	97	98	97	97	92	92	573	0	98	95	96	97	96	96	578	0
Anika Corsi	Jacksonville St.	Jan. 16, 2017	Air Force	0	0	0	0	0	0	0	0	0	0	0	0	0	0	0	0
Trace Haynes	Jacksonville St.	Jan. 16, 2017	Air Force	95	93	96	98	88	91	561	0	96	97	96	93	97	94	573	0
Brandon Henson	Jacksonville St.	Jan. 16, 2017	Air Force	0	0	0	0	0	0	0	0	0	0	0	0	0	0	0	0
Brandon Muske	Jacksonville St.	Jan. 16, 2017	Air Force	99	95	99	97	94	97	581	0	100	99	100	100	100	100	599	0
Kyle Ordille	Jacksonville St.	Jan. 16, 2017	Air Force	0	0	0	0	0	0	0	0	0	0	0	0	0	0	0	0
Carleigh Peters	Jacksonville St.	Jan. 16, 2017	Air Force	0	0	0	0	0	0	0	0	0	0	0	0	0	0	0	0
Garrett Rabel	Jacksonville St.	Jan. 16, 2017	Air Force	96	94	97	97	92	89	565	0	98	93	97	97	92	91	568	0
Tyler Ramos	Jacksonville St.	Jan. 16, 2017	Air Force	0	0	0	0	0	0	0	0	0	0	0	0	0	0	0	0
Mekenna Richardson	Jacksonville St.	Jan. 16, 2017	Air Force	96	96	98	96	89	93	568	0	96	100	98	94	97	94	579	0
Carter Santrock	Jacksonville St.	Jan. 16, 2017	Air Force	92	94	99	99	93	90	567	0	98	98	97	99	98	94	584	0
Zach Schmidt	Jacksonville St.	Jan. 16, 2017	Air Force	96	92	97	98	93	94	570	0	95	97	96	96	95	99	578	0
David Sink	Jacksonville St.	Jan. 16, 2017	Air Force	97	98	99	96	95	93	578	0	95	94	97	96	96	97	575	0
Alex Bapties	UT Martin	Jan. 17, 2017	UT Martin	90	92	99	95	82	87	545	0	95	91	94	98	95	90	563	0
Brigitte Curcio	UT Martin	Jan. 17, 2017	UT Martin	95	94	97	93	89	92	560	0	0	0	0	0	0	0	0	0
Andre Delcalzo	UT Martin	Jan. 17, 2017	UT Martin	89	91	97	97	89	88	551	0	0	0	0	0	0	0	0	0
Logan Hunt	UT Martin	Jan. 17, 2017	UT Martin	87	94	96	98	86	86	547	0	95	93	94	94	95	91	562	0
Kaitlin Korinek	UT Martin	Jan. 17, 2017	UT Martin	94	91	96	99	96	94	570	0	99	98	99	100	99	99	594	0
Joe Martin	UT Martin	Jan. 17, 2017	UT Martin	96	99	99	98	91	92	575	0	97	98	96	97	97	94	579	0
Alex Tamboli	UT Martin	Jan. 17, 2017	UT Martin	92	96	99	98	91	91	567	0	96	95	97	94	97	93	572	0
Sarah Banks	Alabama Birmingham	Jan. 17, 2017	UT Martin	0	0	0	0	0	0	0	0	91	96	95	96	97	91	566	0
Steven Bugg	Alabama Birmingham	Jan. 17, 2017	UT Martin	0	0	0	0	0	0	0	0	0	0	0	0	0	0	0	0
Selina Curren	Alabama Birmingham	Jan. 17, 2017	UT Martin	0	0	0	0	0	0	0	0	0	0	0	0	0	0	0	0
Lindsey Hill	Alabama Birmingham	Jan. 17, 2017	UT Martin	0	0	0	0	0	0	0	0	0	0	0	0	0	0	0	0
Isaac King	Alabama Birmingham	Jan. 17, 2017	UT Martin	0	0	0	0	0	0	0	0	91	90	94	92	91	81	539	0
Kristie Lloyd	Alabama Birmingham	Jan. 17, 2017	UT Martin	0	0	0	0	0	0	0	0	93	90	94	84	87	94	542	0
Logan Short	Alabama Birmingham	Jan. 17, 2017	UT Martin	0	0	0	0	0	0	0	0	0	0	0	0	0	0	0	0
Mallory Sisk	Alabama Birmingham	Jan. 17, 2017	UT Martin	0	0	0	0	0	0	0	0	0	0	0	0	0	0	0	0
Micah Smith	Alabama Birmingham	Jan. 17, 2017	UT Martin	0	0	0	0	0	0	0	0	0	0	0	0	0	0	0	0
Emily Stover	Alabama Birmingham	Jan. 17, 2017	UT Martin	0	0	0	0	0	0	0	0	94	87	89	93	91	86	540	0
Ella Von Canon	Alabama Birmingham	Jan. 17, 2017	UT Martin	0	0	0	0	0	0	0	0	0	0	0	0	0	0	0	0
Lilly Vonderau	Alabama Birmingham	Jan. 17, 2017	UT Martin	0	0	0	0	0	0	0	0	96	98	90	96	96	95	571	0
Erin Bell	UT Martin (W)	Jan. 17, 2017	UT Martin	0	0	0	0	0	0	0	0	0	0	0	0	0	0	0	0
Ashley Coots	UT Martin (W)	Jan. 17, 2017	UT Martin	91	95	97	96	87	85	551	0	93	94	96	95	94	94	566	0
Lindsey Flint	UT Martin (W)	Jan. 17, 2017	UT Martin	92	91	96	97	93	84	553	0	91	96	90	94	93	92	556	0
Amanda Mayo	UT Martin (W)	Jan. 17, 2017	UT Martin	89	92	95	95	85	81	537	0	89	86	93	88	95	86	537	0
Jennifer Plocinik	UT Martin (W)	Jan. 17, 2017	UT Martin	88	93	98	96	93	93	561	0	98	97	93	100	98	98	584	0
Brianna Sawyers	UT Martin (W)	Jan. 17, 2017	UT Martin	93	86	99	98	94	90	560	0	94	97	94	97	97	95	574	0
Alyson Sylvester	UT Martin (W)	Jan. 17, 2017	UT Martin	94	96	97	95	92	95	569	0	96	97	96	95	95	96	575	0
Lucas Figi	Navy	Jan. 20, 2017	West Virginia	0	0	0	0	0	0	0	0	0	0	0	0	0	0	0	0
Maggie Guetersloh	Navy	Jan. 20, 2017	West Virginia	0	0	0	0	0	0	0	0	0	0	0	0	0	0	0	0
Amy Hammer	Navy	Jan. 20, 2017	West Virginia	0	0	0	0	0	0	0	0	0	0	0	0	0	0	0	0
Daniel Jonas	Navy	Jan. 20, 2017	West Virginia	95	97	99	99	95	94	579	0	95	98	98	96	100	96	583	0
Kestrel Kuhne	Navy	Jan. 20, 2017	West Virginia	92	91	100	100	94	94	571	0	98	99	96	97	99	96	585	0
Alex Muzzioli	Navy	Jan. 20, 2017	West Virginia	96	95	97	98	93	95	574	0	97	97	98	99	100	97	588	0
Brandon Pippin	Navy	Jan. 20, 2017	West Virginia	0	0	0	0	0	0	0	0	0	0	0	0	0	0	0	0
Nash Richardson	Navy	Jan. 20, 2017	West Virginia	0	0	0	0	0	0	0	0	0	0	0	0	0	0	0	0
Thomas Sarant	Navy	Jan. 20, 2017	West Virginia	94	95	97	100	94	97	577	0	95	97	97	97	100	98	584	0
Josh Watson	Navy	Jan. 20, 2017	West Virginia	98	97	100	99	96	91	581	0	96	98	99	95	95	98	581	0
Jack Anderson	West Virginia	Jan. 20, 2017	West Virginia	93	93	95	98	93	97	569	0	97	97	97	98	99	94	582	0
Will Anti	West Virginia	Jan. 20, 2017	West Virginia	98	99	99	100	96	98	590	0	97	97	97	96	99	96	582	0
Milica Babic	West Virginia	Jan. 20, 2017	West Virginia	98	95	99	99	100	97	588	0	100	100	100	100	99	99	598	0
Noah Barker	West Virginia	Jan. 20, 2017	West Virginia	0	0	0	0	0	0	0	0	0	0	0	0	0	0	0	0
Elizabeth Gratz	West Virginia	Jan. 20, 2017	West Virginia	99	97	100	99	96	92	583	0	100	100	99	98	100	97	594	0
Jean-Pierre Lucas	West Virginia	Jan. 20, 2017	West Virginia	99	94	99	99	94	97	582	0	100	99	99	98	99	100	595	0
Morgan Phillips	West Virginia	Jan. 20, 2017	West Virginia	98	98	100	98	95	96	585	0	100	100	97	98	100	99	594	0
Ginny Thrasher	West Virginia	Jan. 20, 2017	West Virginia	97	95	100	100	97	96	585	0	100	100	99	99	100	99	597	0
Billy Azzinaro	Kentucky	Jan. 20, 2017	Murray St.	94	97	97	99	92	93	572	0	97	100	98	98	97	99	589	0
Jenna Bethea	Kentucky	Jan. 20, 2017	Murray St.	88	96	98	99	97	95	573	0	97	100	97	100	98	99	591	0
Hanna Carr	Kentucky	Jan. 20, 2017	Murray St.	98	94	99	98	95	94	578	0	98	99	100	98	98	98	591	0
Morgan Duerr	Kentucky	Jan. 20, 2017	Murray St.	96	96	98	96	93	92	571	0	95	95	97	98	98	96	579	0
Ian Foos	Kentucky	Jan. 20, 2017	Murray St.	93	92	97	95	92	93	562	0	97	100	96	96	97	97	583	0
Carmen Fry	Kentucky	Jan. 20, 2017	Murray St.	97	95	99	98	90	94	573	0	97	97	97	97	99	95	582	0
Heather Kirby	Kentucky	Jan. 20, 2017	Murray St.	97	96	99	98	96	94	580	0	97	100	99	99	99	99	593	0
Sonya May	Kentucky	Jan. 20, 2017	Murray St.	92	98	98	98	96	98	580	0	98	95	97	99	98	98	585	0
Andrew Miller	Kentucky	Jan. 20, 2017	Murray St.	0	0	0	0	0	0	0	0	0	0	0	0	0	0	0	0
Cathryn Papasodora	Kentucky	Jan. 20, 2017	Murray St.	95	97	98	100	96	98	584	0	98	99	99	96	98	98	588	0
Jason Scharbel	Kentucky	Jan. 20, 2017	Murray St.	97	99	98	99	91	95	579	0	98	99	95	95	97	96	580	0
Jason Spaude	Kentucky	Jan. 20, 2017	Murray St.	99	97	98	100	91	95	580	0	96	99	99	98	98	99	589	0
Bobby Broadstreet	Murray St.	Jan. 20, 2017	Murray St.	97	99	96	99	98	95	584	0	100	98	99	100	98	97	592	0
Meike Drewell	Murray St.	Jan. 20, 2017	Murray St.	95	97	99	100	96	92	579	0	97	98	97	97	97	98	584	0
Ben Estes	Murray St.	Jan. 20, 2017	Murray St.	94	98	99	98	92	95	576	0	97	100	97	97	98	98	587	0
Shelby Huber	Murray St.	Jan. 20, 2017	Murray St.	95	95	96	100	89	93	568	0	96	100	96	94	99	98	583	0
Mackenzie Martin	Murray St.	Jan. 20, 2017	Murray St.	98	99	99	99	96	96	587	0	99	100	99	100	100	97	595	0
Ivan Roe	Murray St.	Jan. 20, 2017	Murray St.	0	0	0	0	0	0	0	0	0	0	0	0	0	0	0	0
Barbara Schlapfer	Murray St.	Jan. 20, 2017	Murray St.	96	95	99	99	95	95	579	0	97	98	99	99	97	97	587	0
Alathea Sellars	Murray St.	Jan. 20, 2017	Murray St.	98	97	99	98	98	97	587	0	99	99	100	100	100	97	595	0
Eric Sloan	Murray St.	Jan. 20, 2017	Murray St.	94	97	99	99	98	93	580	0	99	94	99	96	98	98	584	0
Zach Eisenberg	North Carolina St.	Jan. 20, 2017	Murray St.	92	93	97	97	93	94	566	0	91	94	97	99	100	98	579	0
Caitlyn Ford	North Carolina St.	Jan. 20, 2017	Murray St.	91	91	96	99	92	94	563	0	99	96	98	97	99	95	584	0
Sarah Hickey	North Carolina St.	Jan. 20, 2017	Murray St.	0	0	0	0	0	0	0	0	0	0	0	0	0	0	0	0
Lucas Kozeniesky	North Carolina St.	Jan. 20, 2017	Murray St.	96	99	98	100	97	96	586	0	100	99	99	99	99	100	596	0
Tyler Lefebvre	North Carolina St.	Jan. 20, 2017	Murray St.	0	0	0	0	0	0	0	0	0	0	0	0	0	0	0	0
Will Marciniak	North Carolina St.	Jan. 20, 2017	Murray St.	96	96	99	96	95	90	572	0	95	95	99	96	97	91	573	0
Derya Pekari	North Carolina St.	Jan. 20, 2017	Murray St.	0	0	0	0	0	0	0	0	0	0	0	0	0	0	0	0
Lauren Phillips	North Carolina St.	Jan. 20, 2017	Murray St.	98	97	99	95	95	95	579	0	98	100	97	100	99	99	593	0
Claire Spina	North Carolina St.	Jan. 20, 2017	Murray St.	91	87	97	99	92	91	557	0	91	98	93	97	95	95	569	0
Cullen Wargo	North Carolina St.	Jan. 20, 2017	Murray St.	0	0	0	0	0	0	0	0	0	0	0	0	0	0	0	0
George Williams	North Carolina St.	Jan. 20, 2017	Murray St.	0	0	0	0	0	0	0	0	0	0	0	0	0	0	0	0
Claire Zanti	North Carolina St.	Jan. 20, 2017	Murray St.	95	96	95	100	94	92	572	0	96	98	97	98	96	98	583	0
Andrew Abernathy	North Georgia	Jan. 20, 2017	Murray St.	94	93	95	94	84	85	545	0	97	97	98	95	93	94	574	0
Eric Azotea	North Georgia	Jan. 20, 2017	Murray St.	0	0	0	0	0	0	0	0	0	0	0	0	0	0	0	0
Ruthanne Conner	North Georgia	Jan. 20, 2017	Murray St.	99	94	98	96	92	90	569	0	94	93	96	97	97	97	574	0
Lucas Gilliland	North Georgia	Jan. 20, 2017	Murray St.	90	96	95	94	86	86	547	0	96	96	94	95	94	95	570	0
Maddie Godwin	North Georgia	Jan. 20, 2017	Murray St.	0	0	0	0	0	0	0	0	0	0	0	0	0	0	0	0
Hannah Peevy	North Georgia	Jan. 20, 2017	Murray St.	0	0	0	0	0	0	0	0	0	0	0	0	0	0	0	0
Jared Rice	North Georgia	Jan. 20, 2017	Murray St.	0	0	0	0	0	0	0	0	0	0	0	0	0	0	0	0
Tobin Sanctuary	North Georgia	Jan. 20, 2017	Murray St.	87	96	99	98	91	87	558	0	95	92	92	90	92	97	558	0
Brianna Shaw	North Georgia	Jan. 20, 2017	Murray St.	97	93	93	97	93	94	567	0	0	0	0	0	0	0	0	0
Dakota Spivey	North Georgia	Jan. 20, 2017	Murray St.	0	0	0	0	0	0	0	0	0	0	0	0	0	0	0	0
David Turner	North Georgia	Jan. 20, 2017	Murray St.	90	94	100	96	91	95	566	0	93	94	97	95	93	99	571	0
Hayley Carroll	Ole Miss	Jan. 20, 2017	Murray St.	0	0	0	0	0	0	0	0	0	0	0	0	0	0	0	0
Harley Gardner	Ole Miss	Jan. 20, 2017	Murray St.	0	0	0	0	0	0	0	0	0	0	0	0	0	0	0	0
Jess Haig	Ole Miss	Jan. 20, 2017	Murray St.	0	0	0	0	0	0	0	0	0	0	0	0	0	0	0	0
Alana Kelly	Ole Miss	Jan. 20, 2017	Murray St.	0	0	0	0	0	0	0	0	0	0	0	0	0	0	0	0
Randi Loudin	Ole Miss	Jan. 20, 2017	Murray St.	0	0	0	0	0	0	0	0	0	0	0	0	0	0	0	0
Marina Noble	Ole Miss	Jan. 20, 2017	Murray St.	0	0	0	0	0	0	0	0	0	0	0	0	0	0	0	0
Samantha Sandifer	Ole Miss	Jan. 20, 2017	Murray St.	0	0	0	0	0	0	0	0	0	0	0	0	0	0	0	0
Kristyn Trump	Ole Miss	Jan. 20, 2017	Murray St.	0	0	0	0	0	0	0	0	0	0	0	0	0	0	0	0
Jillian Tyler	Ole Miss	Jan. 20, 2017	Murray St.	0	0	0	0	0	0	0	0	0	0	0	0	0	0	0	0
Ali Weisz	Ole Miss	Jan. 20, 2017	Murray St.	0	0	0	0	0	0	0	0	0	0	0	0	0	0	0	0
Alex Bapties	UT Martin	Jan. 20, 2017	Murray St.	92	94	94	93	87	86	546	0	96	91	95	97	92	97	568	0
Brigitte Curcio	UT Martin	Jan. 20, 2017	Murray St.	94	92	94	99	89	88	556	0	98	96	91	94	96	97	572	0
Andre Delcalzo	UT Martin	Jan. 20, 2017	Murray St.	92	92	97	93	87	91	552	0	88	94	90	95	93	88	548	0
Logan Hunt	UT Martin	Jan. 20, 2017	Murray St.	92	95	97	97	95	92	568	0	94	92	98	95	93	99	571	0
Kaitlin Korinek	UT Martin	Jan. 20, 2017	Murray St.	96	95	97	96	98	97	579	0	97	95	98	97	95	99	581	0
Joe Martin	UT Martin	Jan. 20, 2017	Murray St.	98	96	100	99	95	96	584	0	94	97	96	98	98	99	582	0
Alex Tamboli	UT Martin	Jan. 20, 2017	Murray St.	93	96	96	98	96	88	567	0	92	96	98	91	93	95	565	0
Jack Berhorst	Memphis	Jan. 20, 2017	Murray St.	0	0	0	0	0	0	0	0	0	0	0	0	0	0	0	0
Haylea Broughton	Memphis	Jan. 20, 2017	Murray St.	96	99	97	95	94	92	573	0	98	97	96	97	98	100	586	0
Levi Clark	Memphis	Jan. 20, 2017	Murray St.	96	94	98	100	92	89	569	0	96	99	99	95	97	100	586	0
Leighton Dempster	Memphis	Jan. 20, 2017	Murray St.	97	95	97	99	93	96	577	0	98	97	100	97	99	98	589	0
Makennon Doran	Memphis	Jan. 20, 2017	Murray St.	96	96	98	100	94	95	579	0	0	0	0	0	0	0	0	0
Amberlie Ezell	Memphis	Jan. 20, 2017	Murray St.	98	95	100	98	93	93	577	0	95	96	98	97	99	97	582	0
Amy Fister	Memphis	Jan. 20, 2017	Murray St.	97	97	98	100	92	98	582	0	94	96	95	96	99	98	578	0
Eli Rischling	Memphis	Jan. 20, 2017	Murray St.	94	96	97	98	89	93	567	0	93	98	94	91	95	95	566	0
Abby Votava	Memphis	Jan. 20, 2017	Murray St.	88	90	98	95	85	93	549	0	98	97	99	97	94	97	582	0
Hunter Behrends	Jacksonville St.	Jan. 20, 2017	Murray St.	0	0	0	0	0	0	0	0	0	0	0	0	0	0	0	0
Austin Cock	Jacksonville St.	Jan. 20, 2017	Murray St.	88	94	98	97	93	89	559	0	97	95	99	96	97	94	578	0
Anika Corsi	Jacksonville St.	Jan. 20, 2017	Murray St.	0	0	0	0	0	0	0	0	0	0	0	0	0	0	0	0
Trace Haynes	Jacksonville St.	Jan. 20, 2017	Murray St.	90	98	98	99	94	90	569	0	0	0	0	0	0	0	0	0
Brandon Henson	Jacksonville St.	Jan. 20, 2017	Murray St.	0	0	0	0	0	0	0	0	0	0	0	0	0	0	0	0
Brandon Muske	Jacksonville St.	Jan. 20, 2017	Murray St.	97	95	97	98	95	94	576	0	99	100	98	99	100	100	596	0
Kyle Ordille	Jacksonville St.	Jan. 20, 2017	Murray St.	0	0	0	0	0	0	0	0	93	95	97	99	95	95	574	0
Carleigh Peters	Jacksonville St.	Jan. 20, 2017	Murray St.	0	0	0	0	0	0	0	0	97	97	97	98	96	96	581	0
Garrett Rabel	Jacksonville St.	Jan. 20, 2017	Murray St.	94	98	99	97	85	92	565	0	0	0	0	0	0	0	0	0
Tyler Ramos	Jacksonville St.	Jan. 20, 2017	Murray St.	0	0	0	0	0	0	0	0	0	0	0	0	0	0	0	0
Mekenna Richardson	Jacksonville St.	Jan. 20, 2017	Murray St.	98	93	100	99	93	89	572	0	96	96	98	94	99	95	578	0
Carter Santrock	Jacksonville St.	Jan. 20, 2017	Murray St.	91	96	100	96	97	95	575	0	95	98	99	97	98	98	585	0
Zach Schmidt	Jacksonville St.	Jan. 20, 2017	Murray St.	94	97	95	96	97	94	573	0	98	98	97	96	99	98	586	0
David Sink	Jacksonville St.	Jan. 20, 2017	Murray St.	97	95	100	98	95	95	580	0	100	97	97	95	97	97	583	0
Sarah Banks	Alabama Birmingham	Jan. 20, 2017	Murray St.	0	0	0	0	0	0	0	0	93	93	98	92	93	94	563	0
Steven Bugg	Alabama Birmingham	Jan. 20, 2017	Murray St.	0	0	0	0	0	0	0	0	85	91	86	91	94	85	532	0
Selina Curren	Alabama Birmingham	Jan. 20, 2017	Murray St.	0	0	0	0	0	0	0	0	0	0	0	0	0	0	0	0
Lindsey Hill	Alabama Birmingham	Jan. 20, 2017	Murray St.	0	0	0	0	0	0	0	0	89	85	95	74	91	82	516	0
Isaac King	Alabama Birmingham	Jan. 20, 2017	Murray St.	0	0	0	0	0	0	0	0	91	88	92	92	89	95	547	0
Kristie Lloyd	Alabama Birmingham	Jan. 20, 2017	Murray St.	0	0	0	0	0	0	0	0	86	90	89	90	84	85	524	0
Logan Short	Alabama Birmingham	Jan. 20, 2017	Murray St.	0	0	0	0	0	0	0	0	0	0	0	0	0	0	0	0
Mallory Sisk	Alabama Birmingham	Jan. 20, 2017	Murray St.	0	0	0	0	0	0	0	0	0	0	0	0	0	0	0	0
Micah Smith	Alabama Birmingham	Jan. 20, 2017	Murray St.	0	0	0	0	0	0	0	0	0	0	0	0	0	0	0	0
Emily Stover	Alabama Birmingham	Jan. 20, 2017	Murray St.	0	0	0	0	0	0	0	0	97	90	91	93	91	87	549	0
Ella Von Canon	Alabama Birmingham	Jan. 20, 2017	Murray St.	0	0	0	0	0	0	0	0	0	0	0	0	0	0	0	0
Lilly Vonderau	Alabama Birmingham	Jan. 20, 2017	Murray St.	0	0	0	0	0	0	0	0	95	96	93	95	95	95	569	0
Erin Bell	UT Martin (W)	Jan. 20, 2017	Murray St.	0	0	0	0	0	0	0	0	0	0	0	0	0	0	0	0
Ashley Coots	UT Martin (W)	Jan. 20, 2017	Murray St.	96	93	98	99	92	84	562	0	96	94	96	92	95	93	566	0
Lindsey Flint	UT Martin (W)	Jan. 20, 2017	Murray St.	94	95	95	98	88	85	555	0	91	95	91	87	97	91	552	0
Amanda Mayo	UT Martin (W)	Jan. 20, 2017	Murray St.	90	94	95	95	85	81	540	0	90	92	88	89	92	93	544	0
Jennifer Plocinik	UT Martin (W)	Jan. 20, 2017	Murray St.	99	98	96	96	93	95	577	0	90	96	95	96	98	97	572	0
Brianna Sawyers	UT Martin (W)	Jan. 20, 2017	Murray St.	98	95	96	97	86	92	564	0	95	97	98	94	96	97	577	0
Alyson Sylvester	UT Martin (W)	Jan. 20, 2017	Murray St.	95	99	98	98	91	89	570	0	96	96	96	95	95	96	574	0
Allison Auten	Citadel	Jan. 21, 2017	Citadel	87	80	95	97	91	93	543	0	98	98	96	98	98	96	584	0
Matthew Davenport	Citadel	Jan. 21, 2017	Citadel	85	86	96	93	90	90	540	0	94	96	97	92	92	92	563	0
Joseph Ferguson	Citadel	Jan. 21, 2017	Citadel	80	84	93	91	82	82	512	0	91	90	94	94	90	91	550	0
Morgan Long	Citadel	Jan. 21, 2017	Citadel	92	88	97	98	93	90	558	0	93	94	94	92	92	96	561	0
Alexander McAlear	Citadel	Jan. 21, 2017	Citadel	94	91	98	97	86	79	545	0	94	95	96	91	96	92	564	0
Patrick Meyer	Citadel	Jan. 21, 2017	Citadel	89	90	93	90	79	88	529	0	88	91	96	88	95	94	552	0
Richie Parra	Citadel	Jan. 21, 2017	Citadel	86	89	92	92	90	81	530	0	93	97	93	95	98	95	571	0
Colton Poole	Citadel	Jan. 21, 2017	Citadel	92	89	94	94	95	95	559	0	93	97	97	95	95	100	577	0
Tommy Simrill	Citadel	Jan. 21, 2017	Citadel	94	83	97	93	70	58	495	0	95	91	91	92	90	93	552	0
Rosemary Kramer	Ga. Southern	Jan. 21, 2017	Citadel	92	96	97	94	82	92	553	0	99	97	97	98	96	96	583	0
Tori Lewis	Ga. Southern	Jan. 21, 2017	Citadel	88	94	93	95	81	84	535	0	93	98	96	95	96	96	574	0
Jennifer Middlebrook	Ga. Southern	Jan. 21, 2017	Citadel	0	0	0	0	0	0	0	0	0	0	0	0	0	0	0	0
Lydia Odlin	Ga. Southern	Jan. 21, 2017	Citadel	0	0	0	0	0	0	0	0	0	0	0	0	0	0	0	0
Chastity Price	Ga. Southern	Jan. 21, 2017	Citadel	88	86	95	94	85	79	527	0	92	92	89	90	89	91	543	0
Courtney Weekley	Ga. Southern	Jan. 21, 2017	Citadel	89	94	96	94	90	91	554	0	96	96	97	97	92	89	567	0
Kathryn Youngblood	Ga. Southern	Jan. 21, 2017	Citadel	93	86	97	97	91	88	552	0	97	96	93	97	95	97	575	0
Carli Cline	Citadel (W)	Jan. 21, 2017	Citadel	92	84	90	91	85	88	530	0	88	91	87	94	95	96	551	0
Brandi Duzz	Citadel (W)	Jan. 21, 2017	Citadel	87	82	92	94	86	68	509	0	93	88	90	89	84	91	535	0
Leah Fenwrick-Wallace	Citadel (W)	Jan. 21, 2017	Citadel	82	90	92	95	80	80	519	0	96	97	96	92	90	92	563	0
Shadonna Littlejohn	Citadel (W)	Jan. 21, 2017	Citadel	80	82	82	83	69	71	467	0	93	85	83	96	94	84	535	0
Tierra Price	Citadel (W)	Jan. 21, 2017	Citadel	87	88	91	89	80	76	511	0	78	78	90	85	89	85	505	0
Faith Totherow	Citadel (W)	Jan. 21, 2017	Citadel	0	0	0	0	0	0	0	0	0	0	0	0	0	0	0	0
Raven Wills	Citadel (W)	Jan. 21, 2017	Citadel	93	79	94	90	85	82	523	0	91	93	87	90	95	87	543	0
Melissa Brizzi	Coast Guard	Jan. 21, 2017	TCU	0	0	0	0	0	0	0	0	0	0	0	0	0	0	0	0
Joseph Busching	Coast Guard	Jan. 21, 2017	TCU	0	0	0	0	0	0	0	0	0	0	0	0	0	0	0	0
Jacob Dupree	Coast Guard	Jan. 21, 2017	TCU	94	90	93	99	84	84	544	0	89	92	92	94	93	93	553	0
Randall Ford	Coast Guard	Jan. 21, 2017	TCU	88	90	95	98	86	94	551	0	94	88	93	93	93	96	557	0
Marshall Grant	Coast Guard	Jan. 21, 2017	TCU	92	83	94	96	86	85	536	0	92	91	91	90	89	94	547	0
Alexandria Harrington	Coast Guard	Jan. 21, 2017	TCU	94	94	96	97	96	93	570	0	98	97	95	94	96	95	575	0
Anthony Lee	Coast Guard	Jan. 21, 2017	TCU	0	0	0	0	0	0	0	0	0	0	0	0	0	0	0	0
Dylan Lorence	Coast Guard	Jan. 21, 2017	TCU	0	0	0	0	0	0	0	0	0	0	0	0	0	0	0	0
Kaden Nichols	Coast Guard	Jan. 21, 2017	TCU	0	0	0	0	0	0	0	0	0	0	0	0	0	0	0	0
Nicholas Paisker	Coast Guard	Jan. 21, 2017	TCU	93	92	96	98	92	89	560	0	96	96	96	95	97	97	577	0
Paul Raynolds	Coast Guard	Jan. 21, 2017	TCU	0	0	0	0	0	0	0	0	0	0	0	0	0	0	0	0
David Rose	Coast Guard	Jan. 21, 2017	TCU	0	0	0	0	0	0	0	0	0	0	0	0	0	0	0	0
Alaric Stone	Coast Guard	Jan. 21, 2017	TCU	0	0	0	0	0	0	0	0	0	0	0	0	0	0	0	0
Nyjah Turner	Coast Guard	Jan. 21, 2017	TCU	0	0	0	0	0	0	0	0	0	0	0	0	0	0	0	0
Deanna Binnie	Ohio State	Jan. 21, 2017	TCU	0	0	0	0	0	0	0	0	0	0	0	0	0	0	0	0
Josh Black	Ohio State	Jan. 21, 2017	TCU	96	95	100	100	92	96	579	0	95	99	98	99	99	96	586	0
Jacob Buchanan	Ohio State	Jan. 21, 2017	TCU	99	98	96	98	96	90	577	0	98	100	99	99	98	97	591	0
Drew Cheezum	Ohio State	Jan. 21, 2017	TCU	97	100	99	97	98	99	590	0	98	98	97	99	99	98	589	0
Anthony Cuozzo	Ohio State	Jan. 21, 2017	TCU	91	97	100	99	92	95	574	0	99	95	98	97	99	100	588	0
Kendal Elder	Ohio State	Jan. 21, 2017	TCU	0	0	0	0	0	0	0	0	0	0	0	0	0	0	0	0
Alli Kissell	Ohio State	Jan. 21, 2017	TCU	0	0	0	0	0	0	0	0	0	0	0	0	0	0	0	0
Mark Matheny	Ohio State	Jan. 21, 2017	TCU	96	99	97	100	96	93	581	0	98	97	100	98	98	98	589	0
Patrick Sardo	Ohio State	Jan. 21, 2017	TCU	0	0	0	0	0	0	0	0	0	0	0	0	0	0	0	0
Michael Steinel	Ohio State	Jan. 21, 2017	TCU	96	96	100	98	98	95	583	0	99	98	100	99	100	100	596	0
Chrissy Thomas	Ohio State	Jan. 21, 2017	TCU	0	0	0	0	0	0	0	0	0	0	0	0	0	0	0	0
Rhiann Travis	Ohio State	Jan. 21, 2017	TCU	0	0	0	0	0	0	0	0	98	98	96	99	99	98	588	0
Bailey Urbach	Ohio State	Jan. 21, 2017	TCU	0	0	0	0	0	0	0	0	0	0	0	0	0	0	0	0
Brendan Whitaker	Ohio State	Jan. 21, 2017	TCU	0	0	0	0	0	0	0	0	0	0	0	0	0	0	0	0
Quintin Wotring	Ohio State	Jan. 21, 2017	TCU	0	0	0	0	0	0	0	0	0	0	0	0	0	0	0	0
Nicholle Benedict	TCU	Jan. 21, 2017	TCU	92	87	97	96	89	94	555	0	94	95	95	97	96	95	572	0
Katie Bridges	TCU	Jan. 21, 2017	TCU	95	95	100	99	88	87	564	0	98	96	94	97	92	96	573	0
Rachel Garner	TCU	Jan. 21, 2017	TCU	97	96	100	100	96	96	585	0	99	99	96	99	100	98	591	0
Ariana Grabowski	TCU	Jan. 21, 2017	TCU	97	98	99	100	96	96	586	0	97	99	98	99	97	98	588	0
Emily Haag	TCU	Jan. 21, 2017	TCU	94	94	98	98	87	87	558	0	93	98	94	95	95	92	567	0
Nicole Hankey	TCU	Jan. 21, 2017	TCU	98	99	97	100	93	95	582	0	99	96	99	98	100	100	592	0
Rachel Kimbell	TCU	Jan. 21, 2017	TCU	97	92	100	96	92	95	572	0	98	99	93	94	95	97	576	0
Sally Li	TCU	Jan. 21, 2017	TCU	96	91	98	98	92	94	569	0	99	100	100	99	98	98	594	0
Casey Lutz	TCU	Jan. 21, 2017	TCU	97	97	97	97	99	96	583	0	100	98	100	99	97	98	592	0
Mindy Miles	TCU	Jan. 21, 2017	TCU	0	0	0	0	0	0	0	0	0	0	0	0	0	0	0	0
Catherine Miller	TCU	Jan. 21, 2017	TCU	97	94	99	97	97	90	574	0	98	99	98	98	98	98	589	0
Meraleigh Randle	TCU	Jan. 21, 2017	TCU	0	0	0	0	0	0	0	0	0	0	0	0	0	0	0	0
Barrett Ray	TCU	Jan. 21, 2017	TCU	90	94	99	98	95	93	569	0	100	97	95	99	96	98	585	0
Lucas Figi	Navy	Jan. 21, 2017	West Virginia	0	0	0	0	0	0	0	0	0	0	0	0	0	0	0	0
Maggie Guetersloh	Navy	Jan. 21, 2017	West Virginia	0	0	0	0	0	0	0	0	0	0	0	0	0	0	0	0
Amy Hammer	Navy	Jan. 21, 2017	West Virginia	0	0	0	0	0	0	0	0	0	0	0	0	0	0	0	0
Daniel Jonas	Navy	Jan. 21, 2017	West Virginia	95	96	99	100	99	96	585	0	96	98	100	97	95	95	581	0
Kestrel Kuhne	Navy	Jan. 21, 2017	West Virginia	98	92	99	99	95	94	577	0	100	97	98	98	98	93	584	0
Alex Muzzioli	Navy	Jan. 21, 2017	West Virginia	94	93	91	98	94	93	563	0	97	97	97	97	97	97	582	0
Brandon Pippin	Navy	Jan. 21, 2017	West Virginia	0	0	0	0	0	0	0	0	0	0	0	0	0	0	0	0
Nash Richardson	Navy	Jan. 21, 2017	West Virginia	0	0	0	0	0	0	0	0	0	0	0	0	0	0	0	0
Thomas Sarant	Navy	Jan. 21, 2017	West Virginia	89	94	100	94	93	91	561	0	97	94	99	99	99	99	587	0
Josh Watson	Navy	Jan. 21, 2017	West Virginia	96	94	98	96	87	92	563	0	100	97	98	98	98	97	588	0
Katie Brown	Nebraska	Jan. 21, 2017	West Virginia	0	0	0	0	0	0	0	0	0	0	0	0	0	0	0	0
Jaycee Carter	Nebraska	Jan. 21, 2017	West Virginia	94	92	98	99	92	92	567	0	98	98	99	98	99	100	592	0
Dacotah Faught	Nebraska	Jan. 21, 2017	West Virginia	95	99	98	99	93	97	581	0	98	98	98	98	98	99	589	0
Kayla Gadeken	Nebraska	Jan. 21, 2017	West Virginia	0	0	0	0	0	0	0	0	0	0	0	0	0	0	0	0
Maddie Korthas	Nebraska	Jan. 21, 2017	West Virginia	0	0	0	0	0	0	0	0	0	0	0	0	0	0	0	0
Rachel Martin	Nebraska	Jan. 21, 2017	West Virginia	94	98	97	97	95	95	576	0	99	99	99	98	100	100	595	0
Jordan Miller	Nebraska	Jan. 21, 2017	West Virginia	0	0	0	0	0	0	0	0	0	0	0	0	0	0	0	0
Samantha Peterson	Nebraska	Jan. 21, 2017	West Virginia	97	96	100	100	93	95	581	0	96	97	99	98	98	98	586	0
Nina Radulovic	Nebraska	Jan. 21, 2017	West Virginia	95	99	95	96	96	96	577	0	96	93	97	100	99	98	583	0
Sarah Sutton	Nebraska	Jan. 21, 2017	West Virginia	0	0	0	0	0	0	0	0	0	0	0	0	0	0	0	0
Hannah Virga	Nebraska	Jan. 21, 2017	West Virginia	0	0	0	0	0	0	0	0	0	0	0	0	0	0	0	0
Rachel Yager	Nebraska	Jan. 21, 2017	West Virginia	0	0	0	0	0	0	0	0	0	0	0	0	0	0	0	0
Katie Brown	Nebraska	Jan. 22, 2017	West Virginia	0	0	0	0	0	0	0	0	0	0	0	0	0	0	0	0
Jaycee Carter	Nebraska	Jan. 22, 2017	West Virginia	93	94	96	95	90	98	566	0	98	98	97	96	98	97	584	0
Dacotah Faught	Nebraska	Jan. 22, 2017	West Virginia	94	94	99	99	94	96	576	0	99	95	97	99	95	98	583	0
Kayla Gadeken	Nebraska	Jan. 22, 2017	West Virginia	91	92	100	100	92	91	566	0	94	96	97	98	95	98	578	0
Maddie Korthas	Nebraska	Jan. 22, 2017	West Virginia	0	0	0	0	0	0	0	0	0	0	0	0	0	0	0	0
Rachel Martin	Nebraska	Jan. 22, 2017	West Virginia	93	93	98	100	94	95	573	0	96	98	98	99	100	98	589	0
Jordan Miller	Nebraska	Jan. 22, 2017	West Virginia	0	0	0	0	0	0	0	0	0	0	0	0	0	0	0	0
Samantha Peterson	Nebraska	Jan. 22, 2017	West Virginia	95	96	98	100	95	93	577	0	97	99	99	95	97	96	583	0
Nina Radulovic	Nebraska	Jan. 22, 2017	West Virginia	98	96	94	100	94	95	577	0	98	99	97	98	100	95	587	0
Sarah Sutton	Nebraska	Jan. 22, 2017	West Virginia	0	0	0	0	0	0	0	0	0	0	0	0	0	0	0	0
Hannah Virga	Nebraska	Jan. 22, 2017	West Virginia	0	0	0	0	0	0	0	0	0	0	0	0	0	0	0	0
Rachel Yager	Nebraska	Jan. 22, 2017	West Virginia	0	0	0	0	0	0	0	0	0	0	0	0	0	0	0	0
Jack Anderson	West Virginia	Jan. 22, 2017	West Virginia	90	94	95	90	89	94	552	0	94	96	95	96	99	96	576	0
Will Anti	West Virginia	Jan. 22, 2017	West Virginia	99	94	99	99	94	97	582	0	98	97	95	100	99	93	582	0
Milica Babic	West Virginia	Jan. 22, 2017	West Virginia	95	97	99	99	100	99	589	0	98	99	100	100	100	100	597	0
Noah Barker	West Virginia	Jan. 22, 2017	West Virginia	0	0	0	0	0	0	0	0	0	0	0	0	0	0	0	0
Elizabeth Gratz	West Virginia	Jan. 22, 2017	West Virginia	96	97	100	99	96	95	583	0	100	97	97	97	95	98	584	0
Jean-Pierre Lucas	West Virginia	Jan. 22, 2017	West Virginia	96	95	99	100	95	95	580	0	96	97	99	100	98	98	588	0
Morgan Phillips	West Virginia	Jan. 22, 2017	West Virginia	97	96	97	99	94	95	578	0	98	100	96	97	97	97	585	0
Ginny Thrasher	West Virginia	Jan. 22, 2017	West Virginia	98	98	100	99	98	99	592	0	100	98	99	99	100	100	596	0
Melissa Brizzi	Coast Guard	Jan. 22, 2017	TCU	0	0	0	0	0	0	0	0	0	0	0	0	0	0	0	0
Joseph Busching	Coast Guard	Jan. 22, 2017	TCU	0	0	0	0	0	0	0	0	0	0	0	0	0	0	0	0
Jacob Dupree	Coast Guard	Jan. 22, 2017	TCU	93	92	93	92	86	82	538	0	88	92	93	93	91	85	542	0
Randall Ford	Coast Guard	Jan. 22, 2017	TCU	95	92	96	99	94	93	569	0	93	96	92	91	98	94	564	0
Marshall Grant	Coast Guard	Jan. 22, 2017	TCU	92	88	95	97	85	89	546	0	92	93	91	90	95	87	548	0
Alexandria Harrington	Coast Guard	Jan. 22, 2017	TCU	92	93	99	98	91	97	570	0	95	97	92	93	98	97	572	0
Anthony Lee	Coast Guard	Jan. 22, 2017	TCU	0	0	0	0	0	0	0	0	0	0	0	0	0	0	0	0
Dylan Lorence	Coast Guard	Jan. 22, 2017	TCU	0	0	0	0	0	0	0	0	0	0	0	0	0	0	0	0
Kaden Nichols	Coast Guard	Jan. 22, 2017	TCU	0	0	0	0	0	0	0	0	0	0	0	0	0	0	0	0
Nicholas Paisker	Coast Guard	Jan. 22, 2017	TCU	96	95	95	97	87	94	564	0	97	92	95	95	98	97	574	0
Paul Raynolds	Coast Guard	Jan. 22, 2017	TCU	0	0	0	0	0	0	0	0	0	0	0	0	0	0	0	0
David Rose	Coast Guard	Jan. 22, 2017	TCU	0	0	0	0	0	0	0	0	0	0	0	0	0	0	0	0
Alaric Stone	Coast Guard	Jan. 22, 2017	TCU	0	0	0	0	0	0	0	0	0	0	0	0	0	0	0	0
Nyjah Turner	Coast Guard	Jan. 22, 2017	TCU	0	0	0	0	0	0	0	0	0	0	0	0	0	0	0	0
Deanna Binnie	Ohio State	Jan. 22, 2017	TCU	0	0	0	0	0	0	0	0	0	0	0	0	0	0	0	0
Josh Black	Ohio State	Jan. 22, 2017	TCU	92	99	98	100	93	94	576	0	98	98	100	97	96	100	589	0
Jacob Buchanan	Ohio State	Jan. 22, 2017	TCU	96	94	98	99	93	96	576	0	98	98	100	99	100	100	595	0
Drew Cheezum	Ohio State	Jan. 22, 2017	TCU	97	100	98	100	96	99	590	0	98	98	99	99	97	98	589	0
Anthony Cuozzo	Ohio State	Jan. 22, 2017	TCU	100	97	96	100	91	89	573	0	97	96	95	98	98	98	582	0
Kendal Elder	Ohio State	Jan. 22, 2017	TCU	0	0	0	0	0	0	0	0	0	0	0	0	0	0	0	0
Alli Kissell	Ohio State	Jan. 22, 2017	TCU	0	0	0	0	0	0	0	0	0	0	0	0	0	0	0	0
Mark Matheny	Ohio State	Jan. 22, 2017	TCU	93	98	100	100	99	96	586	0	99	95	97	97	98	100	586	0
Patrick Sardo	Ohio State	Jan. 22, 2017	TCU	0	0	0	0	0	0	0	0	0	0	0	0	0	0	0	0
Michael Steinel	Ohio State	Jan. 22, 2017	TCU	95	98	99	98	94	91	575	0	100	99	99	99	97	98	592	0
Chrissy Thomas	Ohio State	Jan. 22, 2017	TCU	0	0	0	0	0	0	0	0	0	0	0	0	0	0	0	0
Rhiann Travis	Ohio State	Jan. 22, 2017	TCU	0	0	0	0	0	0	0	0	98	100	99	99	100	98	594	0
Bailey Urbach	Ohio State	Jan. 22, 2017	TCU	0	0	0	0	0	0	0	0	0	0	0	0	0	0	0	0
Brendan Whitaker	Ohio State	Jan. 22, 2017	TCU	0	0	0	0	0	0	0	0	0	0	0	0	0	0	0	0
Quintin Wotring	Ohio State	Jan. 22, 2017	TCU	0	0	0	0	0	0	0	0	0	0	0	0	0	0	0	0
Zach Eisenberg	North Carolina St.	Jan. 22, 2017	Murray St.	87	92	97	99	90	90	555	0	93	95	99	97	97	98	579	0
Caitlyn Ford	North Carolina St.	Jan. 22, 2017	Murray St.	91	93	94	98	96	95	567	0	95	98	99	95	98	97	582	0
Sarah Hickey	North Carolina St.	Jan. 22, 2017	Murray St.	0	0	0	0	0	0	0	0	0	0	0	0	0	0	0	0
Lucas Kozeniesky	North Carolina St.	Jan. 22, 2017	Murray St.	100	98	99	99	92	96	584	0	99	99	100	99	98	99	594	0
Tyler Lefebvre	North Carolina St.	Jan. 22, 2017	Murray St.	0	0	0	0	0	0	0	0	0	0	0	0	0	0	0	0
Will Marciniak	North Carolina St.	Jan. 22, 2017	Murray St.	96	98	98	98	95	95	580	0	94	97	98	94	98	93	574	0
Derya Pekari	North Carolina St.	Jan. 22, 2017	Murray St.	0	0	0	0	0	0	0	0	0	0	0	0	0	0	0	0
Lauren Phillips	North Carolina St.	Jan. 22, 2017	Murray St.	96	96	99	98	94	93	576	0	99	99	99	98	97	97	589	0
Claire Spina	North Carolina St.	Jan. 22, 2017	Murray St.	94	88	98	96	94	94	564	0	95	98	94	97	93	97	574	0
Cullen Wargo	North Carolina St.	Jan. 22, 2017	Murray St.	0	0	0	0	0	0	0	0	0	0	0	0	0	0	0	0
George Williams	North Carolina St.	Jan. 22, 2017	Murray St.	0	0	0	0	0	0	0	0	0	0	0	0	0	0	0	0
Claire Zanti	North Carolina St.	Jan. 22, 2017	Murray St.	95	95	97	98	92	91	568	0	99	95	96	100	98	97	585	0
Hayley Carroll	Ole Miss	Jan. 22, 2017	Murray St.	91	95	97	99	93	92	567	0	95	99	96	98	96	97	581	0
Harley Gardner	Ole Miss	Jan. 22, 2017	Murray St.	92	95	99	99	93	94	572	0	97	97	97	99	96	99	585	0
Jess Haig	Ole Miss	Jan. 22, 2017	Murray St.	96	98	99	98	92	95	578	0	98	98	99	99	100	100	594	0
Alana Kelly	Ole Miss	Jan. 22, 2017	Murray St.	95	99	98	98	92	91	573	0	97	97	97	98	96	95	580	0
Randi Loudin	Ole Miss	Jan. 22, 2017	Murray St.	92	90	100	98	94	96	570	0	96	96	98	97	97	94	578	0
Marina Noble	Ole Miss	Jan. 22, 2017	Murray St.	0	0	0	0	0	0	0	0	0	0	0	0	0	0	0	0
Samantha Sandifer	Ole Miss	Jan. 22, 2017	Murray St.	95	96	96	92	91	91	561	0	98	95	96	99	98	95	581	0
Kristyn Trump	Ole Miss	Jan. 22, 2017	Murray St.	97	92	99	99	92	92	571	0	99	98	97	95	95	99	583	0
Jillian Tyler	Ole Miss	Jan. 22, 2017	Murray St.	92	96	99	99	93	90	569	0	99	95	94	97	95	97	577	0
Ali Weisz	Ole Miss	Jan. 22, 2017	Murray St.	96	97	97	97	95	95	577	0	100	100	99	98	100	99	596	0
Katie Brown	Nebraska	Jan. 28, 2017	Memphis	0	0	0	0	0	0	0	0	0	0	0	0	0	0	0	0
Jaycee Carter	Nebraska	Jan. 28, 2017	Memphis	93	94	96	98	91	96	568	0	96	98	99	98	100	98	589	0
Dacotah Faught	Nebraska	Jan. 28, 2017	Memphis	92	96	98	98	94	95	573	0	100	98	99	99	99	98	593	0
Kayla Gadeken	Nebraska	Jan. 28, 2017	Memphis	0	0	0	0	0	0	0	0	0	0	0	0	0	0	0	0
Maddie Korthas	Nebraska	Jan. 28, 2017	Memphis	0	0	0	0	0	0	0	0	0	0	0	0	0	0	0	0
Rachel Martin	Nebraska	Jan. 28, 2017	Memphis	94	98	99	100	95	96	582	0	98	97	99	99	97	100	590	0
Jordan Miller	Nebraska	Jan. 28, 2017	Memphis	0	0	0	0	0	0	0	0	0	0	0	0	0	0	0	0
Samantha Peterson	Nebraska	Jan. 28, 2017	Memphis	98	92	99	99	93	93	574	0	96	98	98	99	95	95	581	0
Nina Radulovic	Nebraska	Jan. 28, 2017	Memphis	97	95	98	98	92	92	572	0	97	98	97	97	98	96	583	0
Sarah Sutton	Nebraska	Jan. 28, 2017	Memphis	0	0	0	0	0	0	0	0	0	0	0	0	0	0	0	0
Hannah Virga	Nebraska	Jan. 28, 2017	Memphis	0	0	0	0	0	0	0	0	0	0	0	0	0	0	0	0
Rachel Yager	Nebraska	Jan. 28, 2017	Memphis	0	0	0	0	0	0	0	0	0	0	0	0	0	0	0	0
Jack Berhorst	Memphis	Jan. 28, 2017	Memphis	99	97	99	96	88	97	576	0	94	94	93	97	97	96	571	0
Haylea Broughton	Memphis	Jan. 28, 2017	Memphis	97	94	98	96	95	92	572	0	99	97	98	100	97	97	588	0
Levi Clark	Memphis	Jan. 28, 2017	Memphis	98	95	98	99	93	95	578	0	98	96	100	96	98	95	583	0
Leighton Dempster	Memphis	Jan. 28, 2017	Memphis	96	94	97	96	94	93	570	0	96	97	100	98	100	98	589	0
Makennon Doran	Memphis	Jan. 28, 2017	Memphis	95	93	98	100	94	93	573	0	96	97	99	97	93	95	577	0
Amberlie Ezell	Memphis	Jan. 28, 2017	Memphis	94	95	99	96	93	93	570	0	99	97	99	95	98	99	587	0
Amy Fister	Memphis	Jan. 28, 2017	Memphis	95	97	98	99	96	91	576	0	99	98	97	99	98	94	585	0
Eli Rischling	Memphis	Jan. 28, 2017	Memphis	92	93	98	99	90	90	562	0	94	97	92	94	93	94	564	0
Abby Votava	Memphis	Jan. 28, 2017	Memphis	84	82	96	94	85	93	534	0	95	94	95	93	97	96	570	0
Hunter Behrends	Jacksonville St.	Jan. 28, 2017	Memphis	0	0	0	0	0	0	0	0	0	0	0	0	0	0	0	0
Austin Cock	Jacksonville St.	Jan. 28, 2017	Memphis	0	0	0	0	0	0	0	0	0	0	0	0	0	0	0	0
Anika Corsi	Jacksonville St.	Jan. 28, 2017	Memphis	0	0	0	0	0	0	0	0	0	0	0	0	0	0	0	0
Trace Haynes	Jacksonville St.	Jan. 28, 2017	Memphis	91	94	99	97	89	90	560	0	96	99	97	95	96	97	580	0
Brandon Henson	Jacksonville St.	Jan. 28, 2017	Memphis	0	0	0	0	0	0	0	0	0	0	0	0	0	0	0	0
Brandon Muske	Jacksonville St.	Jan. 28, 2017	Memphis	96	97	97	97	95	94	576	0	100	99	99	96	98	98	590	0
Kyle Ordille	Jacksonville St.	Jan. 28, 2017	Memphis	0	0	0	0	0	0	0	0	0	0	0	0	0	0	0	0
Carleigh Peters	Jacksonville St.	Jan. 28, 2017	Memphis	0	0	0	0	0	0	0	0	0	0	0	0	0	0	0	0
Garrett Rabel	Jacksonville St.	Jan. 28, 2017	Memphis	0	0	0	0	0	0	0	0	0	0	0	0	0	0	0	0
Tyler Ramos	Jacksonville St.	Jan. 28, 2017	Memphis	0	0	0	0	0	0	0	0	0	0	0	0	0	0	0	0
Mekenna Richardson	Jacksonville St.	Jan. 28, 2017	Memphis	94	97	95	97	90	95	568	0	96	96	98	98	94	97	579	0
Carter Santrock	Jacksonville St.	Jan. 28, 2017	Memphis	95	95	98	100	94	91	573	0	97	98	97	99	97	99	587	0
Zach Schmidt	Jacksonville St.	Jan. 28, 2017	Memphis	92	97	97	100	92	96	574	0	96	97	96	93	97	97	576	0
David Sink	Jacksonville St.	Jan. 28, 2017	Memphis	97	97	97	99	96	93	579	0	95	96	96	94	95	99	575	0
Spencer Brandon	Air Force	Jan. 28, 2017	Citadel	97	95	99	100	93	88	572	0	96	95	97	99	98	97	582	0
Spencer Cap	Air Force	Jan. 28, 2017	Citadel	93	95	100	100	95	95	578	0	99	98	99	99	98	98	591	0
Kyle Cox	Air Force	Jan. 28, 2017	Citadel	0	0	0	0	0	0	0	0	0	0	0	0	0	0	0	0
Ryan Jacobs	Air Force	Jan. 28, 2017	Citadel	98	97	96	98	94	94	577	0	100	100	98	99	99	98	594	0
Noah Kwock	Air Force	Jan. 28, 2017	Citadel	0	0	0	0	0	0	0	0	0	0	0	0	0	0	0	0
Nick Learn	Air Force	Jan. 28, 2017	Citadel	94	93	96	99	89	94	565	0	94	96	96	98	97	95	576	0
Logan Ogden	Air Force	Jan. 28, 2017	Citadel	96	96	99	99	96	97	583	0	97	94	97	96	98	97	579	7
Mary Simonton	Air Force	Jan. 28, 2017	Citadel	0	0	0	0	0	0	0	0	0	0	0	0	0	0	0	0
Anna Weilbacher	Air Force	Jan. 28, 2017	Citadel	100	96	100	98	94	95	583	0	99	98	97	99	100	98	591	0
Allison Auten	Citadel	Jan. 28, 2017	Citadel	91	89	95	95	90	91	551	0	97	98	93	95	98	97	578	0
Matthew Davenport	Citadel	Jan. 28, 2017	Citadel	91	86	91	91	89	94	542	0	95	93	94	95	96	96	569	0
Joseph Ferguson	Citadel	Jan. 28, 2017	Citadel	85	88	92	92	87	79	523	0	90	91	89	91	94	93	548	0
Morgan Long	Citadel	Jan. 28, 2017	Citadel	94	92	97	98	88	94	563	0	97	95	95	95	94	96	572	0
Alexander McAlear	Citadel	Jan. 28, 2017	Citadel	93	95	94	97	90	90	559	0	95	90	93	90	91	95	554	0
Patrick Meyer	Citadel	Jan. 28, 2017	Citadel	93	92	96	97	86	88	552	0	94	95	94	91	91	88	553	0
Richie Parra	Citadel	Jan. 28, 2017	Citadel	89	81	92	95	86	89	532	0	94	93	92	96	97	93	565	0
Colton Poole	Citadel	Jan. 28, 2017	Citadel	94	94	91	97	93	85	554	0	97	96	94	94	97	98	576	0
Tommy Simrill	Citadel	Jan. 28, 2017	Citadel	87	84	98	93	77	86	525	0	91	95	89	85	94	92	546	0
Andrew Abernathy	North Georgia	Jan. 28, 2017	Citadel	96	95	97	97	86	89	560	0	94	96	94	98	97	97	576	0
Eric Azotea	North Georgia	Jan. 28, 2017	Citadel	0	0	0	0	0	0	0	0	0	0	0	0	0	0	0	0
Ruthanne Conner	North Georgia	Jan. 28, 2017	Citadel	95	98	98	96	95	93	575	0	96	99	99	95	99	95	583	0
Lucas Gilliland	North Georgia	Jan. 28, 2017	Citadel	87	95	96	96	89	89	552	0	0	0	0	0	0	0	0	0
Maddie Godwin	North Georgia	Jan. 28, 2017	Citadel	0	0	0	0	0	0	0	0	0	0	0	0	0	0	0	0
Hannah Peevy	North Georgia	Jan. 28, 2017	Citadel	0	0	0	0	0	0	0	0	0	0	0	0	0	0	0	0
Jared Rice	North Georgia	Jan. 28, 2017	Citadel	0	0	0	0	0	0	0	0	0	0	0	0	0	0	0	0
Tobin Sanctuary	North Georgia	Jan. 28, 2017	Citadel	94	91	100	100	83	88	556	0	94	97	91	96	98	93	569	0
Brianna Shaw	North Georgia	Jan. 28, 2017	Citadel	91	92	93	98	96	91	561	0	91	96	93	96	96	93	565	3
Dakota Spivey	North Georgia	Jan. 28, 2017	Citadel	0	0	0	0	0	0	0	0	0	0	0	0	0	0	0	0
David Turner	North Georgia	Jan. 28, 2017	Citadel	87	95	95	96	93	88	554	0	90	98	97	93	94	95	567	0
Kealie Engels	Wofford	Jan. 28, 2017	Citadel	0	0	0	0	0	0	0	0	0	0	0	0	0	0	0	0
Seth Flanagan	Wofford	Jan. 28, 2017	Citadel	85	89	90	95	77	72	508	0	88	92	89	90	93	91	543	0
Cierra Holcombe	Wofford	Jan. 28, 2017	Citadel	92	96	96	96	84	93	557	0	93	92	89	94	97	93	558	0
Carson Howell	Wofford	Jan. 28, 2017	Citadel	0	0	0	0	0	0	0	0	0	0	0	0	0	0	0	0
Nicholas Hunter	Wofford	Jan. 28, 2017	Citadel	83	89	96	93	87	92	540	0	89	98	92	92	97	93	561	0
Zachry Hunter	Wofford	Jan. 28, 2017	Citadel	85	83	90	89	72	81	500	0	89	90	87	85	87	87	525	0
Reid Schuster	Wofford	Jan. 28, 2017	Citadel	0	0	0	0	0	0	0	0	0	0	0	0	0	0	0	0
William Davidson	VMI	Jan. 28, 2017	Citadel	95	92	95	97	89	86	554	0	95	92	90	95	94	94	560	0
Andrew Hickey	VMI	Jan. 28, 2017	Citadel	96	91	98	98	84	90	557	0	97	93	94	94	93	92	563	0
Jacob Hunter	VMI	Jan. 28, 2017	Citadel	92	89	96	96	87	90	550	0	97	97	96	95	96	93	574	0
Zachary Johnson	VMI	Jan. 28, 2017	Citadel	84	94	99	98	93	89	557	0	92	94	91	95	91	95	558	0
Mathew Lusardi	VMI	Jan. 28, 2017	Citadel	0	0	0	0	0	0	0	0	96	97	91	95	95	93	567	0
Chris Milliken	VMI	Jan. 28, 2017	Citadel	0	0	0	0	0	0	0	0	91	94	97	93	94	97	566	0
John Pitman	VMI	Jan. 28, 2017	Citadel	92	91	98	96	81	87	545	0	0	0	0	0	0	0	0	0
Nick Reynolds	VMI	Jan. 28, 2017	Citadel	94	89	97	96	86	85	547	0	94	96	96	95	96	96	573	0
Carli Cline	Citadel (W)	Jan. 28, 2017	Citadel	86	81	94	93	86	79	519	0	86	94	87	97	89	95	548	0
Brandi Duzz	Citadel (W)	Jan. 28, 2017	Citadel	0	0	0	0	0	0	0	0	0	0	0	0	0	0	0	0
Leah Fenwrick-Wallace	Citadel (W)	Jan. 28, 2017	Citadel	83	87	94	94	79	84	521	0	93	95	93	96	96	97	570	0
Shadonna Littlejohn	Citadel (W)	Jan. 28, 2017	Citadel	89	89	96	90	70	78	512	0	90	86	96	95	91	89	547	0
Tierra Price	Citadel (W)	Jan. 28, 2017	Citadel	87	73	82	90	61	69	462	0	80	82	83	85	88	82	500	0
Faith Totherow	Citadel (W)	Jan. 28, 2017	Citadel	94	91	95	98	74	64	516	0	88	90	80	90	93	89	530	0
Raven Wills	Citadel (W)	Jan. 28, 2017	Citadel	82	83	80	87	87	86	505	0	89	90	92	89	85	81	526	0
Kelia Aardema	VMI (W)	Jan. 28, 2017	Citadel	0	0	0	0	0	0	0	0	0	0	0	0	0	0	0	0
Samantha Alexander	VMI (W)	Jan. 28, 2017	Citadel	93	94	93	97	88	92	557	0	96	97	94	96	97	92	572	0
Ellana Avery	VMI (W)	Jan. 28, 2017	Citadel	89	84	91	95	72	89	520	0	0	0	0	0	0	0	0	0
Sabrina Bell	VMI (W)	Jan. 28, 2017	Citadel	0	0	0	0	0	0	0	0	91	92	94	92	91	95	555	0
Alice Chiu	VMI (W)	Jan. 28, 2017	Citadel	0	0	0	0	0	0	0	0	0	0	0	0	0	0	0	0
Jamie Foster	VMI (W)	Jan. 28, 2017	Citadel	0	0	0	0	0	0	0	0	0	0	0	0	0	0	0	0
Joelle Henry	VMI (W)	Jan. 28, 2017	Citadel	0	0	0	0	0	0	0	0	0	0	0	0	0	0	0	0
Rachel Jankelow	VMI (W)	Jan. 28, 2017	Citadel	90	75	93	92	83	76	509	0	91	91	93	92	96	95	558	0
Kerrie Lightfoot	VMI (W)	Jan. 28, 2017	Citadel	83	89	94	93	89	76	524	0	93	91	91	95	96	95	561	0
Loyce Lightfoot	VMI (W)	Jan. 28, 2017	Citadel	85	88	90	95	86	89	533	0	91	92	94	92	91	95	555	0
Kaitlyn Morrison	VMI (W)	Jan. 28, 2017	Citadel	0	0	0	0	0	0	0	0	0	0	0	0	0	0	0	0
Katherine Watson	VMI (W)	Jan. 28, 2017	Citadel	86	88	98	94	92	90	548	0	93	93	94	90	93	96	559	0
Zach Eisenberg	North Carolina St.	Jan. 28, 2017	North Carolina St.	0	0	0	0	0	0	0	0	0	0	0	0	0	0	0	0
Caitlyn Ford	North Carolina St.	Jan. 28, 2017	North Carolina St.	96	98	92	98	96	98	578	21	99	95	99	99	100	99	591	35
Sarah Hickey	North Carolina St.	Jan. 28, 2017	North Carolina St.	0	0	0	0	0	0	0	0	0	0	0	0	0	0	0	0
Lucas Kozeniesky	North Carolina St.	Jan. 28, 2017	North Carolina St.	95	93	100	100	93	96	577	24	98	100	97	97	99	99	590	41
Tyler Lefebvre	North Carolina St.	Jan. 28, 2017	North Carolina St.	0	0	0	0	0	0	0	0	0	0	0	0	0	0	0	0
Will Marciniak	North Carolina St.	Jan. 28, 2017	North Carolina St.	96	98	95	97	86	94	566	22	96	97	96	95	94	94	572	24
Derya Pekari	North Carolina St.	Jan. 28, 2017	North Carolina St.	97	86	97	99	89	85	553	16	98	98	96	98	94	97	581	34
Lauren Phillips	North Carolina St.	Jan. 28, 2017	North Carolina St.	97	94	98	98	98	93	578	31	100	100	100	98	98	100	596	49
Claire Spina	North Carolina St.	Jan. 28, 2017	North Carolina St.	0	0	0	0	0	0	0	0	0	0	0	0	0	0	0	0
Cullen Wargo	North Carolina St.	Jan. 28, 2017	North Carolina St.	0	0	0	0	0	0	0	0	0	0	0	0	0	0	0	0
George Williams	North Carolina St.	Jan. 28, 2017	North Carolina St.	0	0	0	0	0	0	0	0	0	0	0	0	0	0	0	0
Claire Zanti	North Carolina St.	Jan. 28, 2017	North Carolina St.	96	92	99	98	94	92	571	19	99	95	98	95	96	97	580	33
Andrew Abernathy	North Georgia	Jan. 28, 2017	North Carolina St.	96	94	95	95	84	91	555	15	96	97	93	96	92	95	569	25
Eric Azotea	North Georgia	Jan. 28, 2017	North Carolina St.	0	0	0	0	0	0	0	0	0	0	0	0	0	0	0	0
Ruthanne Conner	North Georgia	Jan. 28, 2017	North Carolina St.	92	95	99	98	93	92	569	21	93	95	96	97	96	96	573	25
Lucas Gilliland	North Georgia	Jan. 28, 2017	North Carolina St.	89	91	95	97	86	89	547	11	96	96	96	98	94	97	577	34
Maddie Godwin	North Georgia	Jan. 28, 2017	North Carolina St.	0	0	0	0	0	0	0	0	0	0	0	0	0	0	0	0
Hannah Peevy	North Georgia	Jan. 28, 2017	North Carolina St.	0	0	0	0	0	0	0	0	0	0	0	0	0	0	0	0
Jared Rice	North Georgia	Jan. 28, 2017	North Carolina St.	0	0	0	0	0	0	0	0	0	0	0	0	0	0	0	0
Tobin Sanctuary	North Georgia	Jan. 28, 2017	North Carolina St.	96	95	100	96	88	92	567	19	97	93	93	95	93	98	569	26
Brianna Shaw	North Georgia	Jan. 28, 2017	North Carolina St.	96	95	98	93	95	92	569	15	98	96	94	97	95	96	576	25
Dakota Spivey	North Georgia	Jan. 28, 2017	North Carolina St.	0	0	0	0	0	0	0	0	0	0	0	0	0	0	0	0
David Turner	North Georgia	Jan. 28, 2017	North Carolina St.	94	95	98	95	78	86	546	17	95	93	99	88	92	97	564	22
William Caruso	MIT	Jan. 28, 2017	USciences	83	82	85	85	75	80	490	0	91	87	94	89	86	89	536	0
Efraim Helman	MIT	Jan. 28, 2017	USciences	0	0	0	0	0	0	0	0	0	0	0	0	0	0	0	0
Yaakov Helman	MIT	Jan. 28, 2017	USciences	0	0	0	0	0	0	0	0	0	0	0	0	0	0	0	0
Jesus Herrera	MIT	Jan. 28, 2017	USciences	93	91	89	92	74	78	517	0	83	90	90	84	92	86	525	0
Alexander Laiman	MIT	Jan. 28, 2017	USciences	0	0	0	0	0	0	0	0	0	0	0	0	0	0	0	0
Gregory Lee	MIT	Jan. 28, 2017	USciences	0	0	0	0	0	0	0	0	0	0	0	0	0	0	0	0
Kelly Mathesius	MIT	Jan. 28, 2017	USciences	85	84	96	96	85	90	536	0	89	91	90	91	98	93	552	0
Elijah Miller	MIT	Jan. 28, 2017	USciences	80	77	87	81	50	55	430	0	77	78	82	77	77	83	474	0
Dylan Modesitt	MIT	Jan. 28, 2017	USciences	81	91	91	89	83	82	517	0	87	87	83	79	82	88	506	0
Kevin Ng	MIT	Jan. 28, 2017	USciences	0	0	0	0	0	0	0	0	0	0	0	0	0	0	0	0
Alex Pacheco	MIT	Jan. 28, 2017	USciences	86	83	91	94	71	77	502	0	83	88	94	81	91	88	525	0
Kevin Petrovic	MIT	Jan. 28, 2017	USciences	0	0	0	0	0	0	0	0	0	0	0	0	0	0	0	0
Thomas Rick	MIT	Jan. 28, 2017	USciences	84	79	95	90	73	71	492	0	76	75	89	81	87	84	492	0
Joel Solis	MIT	Jan. 28, 2017	USciences	0	0	0	0	0	0	0	0	0	0	0	0	0	0	0	0
Rachel Hubal	USciences	Jan. 28, 2017	USciences	92	88	92	90	71	86	519	0	81	89	88	88	85	87	518	0
Angela Kang	USciences	Jan. 28, 2017	USciences	93	90	95	93	89	81	541	0	84	78	88	88	91	95	524	0
Brittany Mahoney	USciences	Jan. 28, 2017	USciences	62	77	86	82	67	58	432	0	73	69	69	69	80	73	433	0
Chris Makosiej	USciences	Jan. 28, 2017	USciences	0	0	0	0	0	0	0	0	0	0	0	0	0	0	0	0
Nick Makosiej	USciences	Jan. 28, 2017	USciences	65	72	77	70	48	60	392	0	76	80	71	76	64	87	454	0
Thomas Nelligan	USciences	Jan. 28, 2017	USciences	0	0	0	0	0	0	0	0	0	0	0	0	0	0	0	0
Matt Popowicz	USciences	Jan. 28, 2017	USciences	91	91	94	91	86	81	534	0	84	83	91	85	88	87	518	0
Andrej Quatrone	USciences	Jan. 28, 2017	USciences	91	87	95	90	85	70	518	0	85	75	85	80	90	87	502	0
Sarah Schnupp	USciences	Jan. 28, 2017	USciences	88	90	96	97	89	91	551	0	94	94	95	92	89	90	554	0
Lauren Stabler	USciences	Jan. 28, 2017	USciences	0	0	0	0	0	0	0	0	0	0	0	0	0	0	0	0
Christina Tipton	USciences	Jan. 28, 2017	USciences	68	74	85	79	46	66	418	0	70	71	68	73	64	64	410	0
Allie Tuman	USciences	Jan. 28, 2017	USciences	88	87	93	97	81	71	517	0	84	79	87	83	85	85	503	0
Anita Varkey	USciences	Jan. 28, 2017	USciences	62	63	85	81	44	45	380	0	84	84	87	87	85	81	508	0
Andrew Visconti	USciences	Jan. 28, 2017	USciences	90	91	98	92	79	82	532	0	90	92	92	88	96	90	548	0
Nick Zsoldos	USciences	Jan. 28, 2017	USciences	92	93	92	97	77	77	528	0	84	84	90	90	86	82	516	0
Spencer Brandon	Air Force	Jan. 29, 2017	Citadel	94	92	98	98	90	91	563	0	96	98	95	97	98	98	582	0
Spencer Cap	Air Force	Jan. 29, 2017	Citadel	96	94	100	99	94	97	580	0	98	98	98	97	99	99	589	0
Kyle Cox	Air Force	Jan. 29, 2017	Citadel	0	0	0	0	0	0	0	0	0	0	0	0	0	0	0	0
Ryan Jacobs	Air Force	Jan. 29, 2017	Citadel	98	98	100	100	94	97	587	0	99	99	99	98	100	98	593	0
Noah Kwock	Air Force	Jan. 29, 2017	Citadel	0	0	0	0	0	0	0	0	0	0	0	0	0	0	0	0
Nick Learn	Air Force	Jan. 29, 2017	Citadel	100	97	98	98	95	92	580	0	95	94	98	98	98	99	582	0
Logan Ogden	Air Force	Jan. 29, 2017	Citadel	97	99	98	99	93	94	580	0	99	98	99	99	99	100	594	0
Mary Simonton	Air Force	Jan. 29, 2017	Citadel	0	0	0	0	0	0	0	0	0	0	0	0	0	0	0	0
Anna Weilbacher	Air Force	Jan. 29, 2017	Citadel	94	95	99	98	97	96	579	0	99	100	99	98	99	99	594	0
Allison Auten	Citadel	Jan. 29, 2017	Citadel	89	90	94	90	83	90	536	0	100	95	98	100	98	99	590	0
Matthew Davenport	Citadel	Jan. 29, 2017	Citadel	0	0	0	0	0	0	0	0	0	0	0	0	0	0	0	0
Joseph Ferguson	Citadel	Jan. 29, 2017	Citadel	0	0	0	0	0	0	0	0	0	0	0	0	0	0	0	0
Morgan Long	Citadel	Jan. 29, 2017	Citadel	91	90	96	93	85	93	548	0	91	97	93	93	96	93	563	0
Alexander McAlear	Citadel	Jan. 29, 2017	Citadel	95	95	95	96	90	86	557	0	93	94	94	91	94	88	554	0
Patrick Meyer	Citadel	Jan. 29, 2017	Citadel	0	0	0	0	0	0	0	0	0	0	0	0	0	0	0	0
Richie Parra	Citadel	Jan. 29, 2017	Citadel	90	93	96	91	85	90	545	0	95	95	95	95	97	95	572	0
Colton Poole	Citadel	Jan. 29, 2017	Citadel	92	93	94	93	95	92	559	0	97	94	98	96	98	97	580	0
Tommy Simrill	Citadel	Jan. 29, 2017	Citadel	0	0	0	0	0	0	0	0	0	0	0	0	0	0	0	0
Carli Cline	Citadel (W)	Jan. 29, 2017	Citadel	88	87	94	96	77	86	528	0	87	93	91	94	93	90	548	0
Brandi Duzz	Citadel (W)	Jan. 29, 2017	Citadel	86	82	88	93	81	70	500	0	91	95	96	91	87	93	553	0
Leah Fenwrick-Wallace	Citadel (W)	Jan. 29, 2017	Citadel	0	0	0	0	0	0	0	0	0	0	0	0	0	0	0	0
Shadonna Littlejohn	Citadel (W)	Jan. 29, 2017	Citadel	85	90	95	91	60	75	496	0	93	93	90	92	90	91	549	0
Tierra Price	Citadel (W)	Jan. 29, 2017	Citadel	78	82	89	93	82	78	502	0	83	84	83	89	87	86	512	0
Faith Totherow	Citadel (W)	Jan. 29, 2017	Citadel	91	91	91	89	82	83	527	0	93	91	91	92	91	85	543	0
Raven Wills	Citadel (W)	Jan. 29, 2017	Citadel	0	0	0	0	0	0	0	0	0	0	0	0	0	0	0	0
Spencer Brandon	Air Force	Jan. 29, 2017	Citadel	94	92	98	98	90	91	563	0	96	98	95	97	98	98	582	0
Spencer Cap	Air Force	Jan. 29, 2017	Citadel	96	94	100	99	94	97	580	0	98	98	98	97	99	99	589	0
Kyle Cox	Air Force	Jan. 29, 2017	Citadel	0	0	0	0	0	0	0	0	0	0	0	0	0	0	0	0
Ryan Jacobs	Air Force	Jan. 29, 2017	Citadel	98	98	100	100	94	97	587	0	99	99	99	98	100	98	593	0
Noah Kwock	Air Force	Jan. 29, 2017	Citadel	0	0	0	0	0	0	0	0	0	0	0	0	0	0	0	0
Nick Learn	Air Force	Jan. 29, 2017	Citadel	100	97	98	98	95	92	580	0	95	94	98	98	98	99	582	0
Logan Ogden	Air Force	Jan. 29, 2017	Citadel	97	99	98	99	93	94	580	0	99	98	99	99	99	100	594	0
Mary Simonton	Air Force	Jan. 29, 2017	Citadel	0	0	0	0	0	0	0	0	0	0	0	0	0	0	0	0
Anna Weilbacher	Air Force	Jan. 29, 2017	Citadel	94	95	99	98	97	96	579	0	99	100	99	98	99	99	594	0
Allison Auten	Citadel	Jan. 29, 2017	Citadel	0	0	0	0	0	0	0	0	0	0	0	0	0	0	0	0
Matthew Davenport	Citadel	Jan. 29, 2017	Citadel	0	0	0	0	0	0	0	0	0	0	0	0	0	0	0	0
Joseph Ferguson	Citadel	Jan. 29, 2017	Citadel	0	0	0	0	0	0	0	0	0	0	0	0	0	0	0	0
Morgan Long	Citadel	Jan. 29, 2017	Citadel	0	0	0	0	0	0	0	0	0	0	0	0	0	0	0	0
Alexander McAlear	Citadel	Jan. 29, 2017	Citadel	0	0	0	0	0	0	0	0	0	0	0	0	0	0	0	0
Patrick Meyer	Citadel	Jan. 29, 2017	Citadel	0	0	0	0	0	0	0	0	0	0	0	0	0	0	0	0
Richie Parra	Citadel	Jan. 29, 2017	Citadel	0	0	0	0	0	0	0	0	0	0	0	0	0	0	0	0
Colton Poole	Citadel	Jan. 29, 2017	Citadel	0	0	0	0	0	0	0	0	0	0	0	0	0	0	0	0
Tommy Simrill	Citadel	Jan. 29, 2017	Citadel	0	0	0	0	0	0	0	0	0	0	0	0	0	0	0	0
Carli Cline	Citadel (W)	Jan. 29, 2017	Citadel	0	0	0	0	0	0	0	0	0	0	0	0	0	0	0	0
Brandi Duzz	Citadel (W)	Jan. 29, 2017	Citadel	0	0	0	0	0	0	0	0	0	0	0	0	0	0	0	0
Leah Fenwrick-Wallace	Citadel (W)	Jan. 29, 2017	Citadel	0	0	0	0	0	0	0	0	0	0	0	0	0	0	0	0
Shadonna Littlejohn	Citadel (W)	Jan. 29, 2017	Citadel	0	0	0	0	0	0	0	0	0	0	0	0	0	0	0	0
Tierra Price	Citadel (W)	Jan. 29, 2017	Citadel	0	0	0	0	0	0	0	0	0	0	0	0	0	0	0	0
Faith Totherow	Citadel (W)	Jan. 29, 2017	Citadel	0	0	0	0	0	0	0	0	0	0	0	0	0	0	0	0
Raven Wills	Citadel (W)	Jan. 29, 2017	Citadel	0	0	0	0	0	0	0	0	0	0	0	0	0	0	0	0
Billy Azzinaro	Kentucky	Jan. 29, 2017	Ohio State	97	96	100	97	93	95	578	0	93	97	98	97	98	100	583	0
Jenna Bethea	Kentucky	Jan. 29, 2017	Ohio State	92	95	99	96	92	92	566	0	99	97	99	97	97	98	587	0
Hanna Carr	Kentucky	Jan. 29, 2017	Ohio State	96	94	100	99	97	99	585	0	96	97	100	100	97	98	588	0
Morgan Duerr	Kentucky	Jan. 29, 2017	Ohio State	97	93	97	97	90	91	565	0	96	96	99	98	98	98	585	0
Ian Foos	Kentucky	Jan. 29, 2017	Ohio State	0	0	0	0	0	0	0	0	93	96	97	97	96	99	578	0
Carmen Fry	Kentucky	Jan. 29, 2017	Ohio State	95	91	99	99	89	90	563	0	0	0	0	0	0	0	0	0
Heather Kirby	Kentucky	Jan. 29, 2017	Ohio State	94	95	99	97	95	93	573	0	98	100	99	100	99	100	596	0
Sonya May	Kentucky	Jan. 29, 2017	Ohio State	94	95	98	98	90	96	571	0	98	96	98	98	97	98	585	0
Andrew Miller	Kentucky	Jan. 29, 2017	Ohio State	0	0	0	0	0	0	0	0	0	0	0	0	0	0	0	0
Cathryn Papasodora	Kentucky	Jan. 29, 2017	Ohio State	92	98	98	96	94	93	571	0	97	99	99	99	97	99	590	0
Jason Scharbel	Kentucky	Jan. 29, 2017	Ohio State	97	97	100	99	94	93	580	0	96	97	96	95	96	97	577	0
Jason Spaude	Kentucky	Jan. 29, 2017	Ohio State	97	95	99	100	95	91	577	0	98	100	97	97	99	100	591	0
Deanna Binnie	Ohio State	Jan. 29, 2017	Ohio State	97	98	100	100	88	90	573	0	0	0	0	0	0	0	0	0
Josh Black	Ohio State	Jan. 29, 2017	Ohio State	93	95	98	99	92	93	570	0	97	96	100	98	99	98	588	0
Jacob Buchanan	Ohio State	Jan. 29, 2017	Ohio State	0	0	0	0	0	0	0	0	0	0	0	0	0	0	0	0
Drew Cheezum	Ohio State	Jan. 29, 2017	Ohio State	97	98	100	96	93	94	578	0	98	99	96	100	99	97	589	0
Anthony Cuozzo	Ohio State	Jan. 29, 2017	Ohio State	90	97	100	97	95	93	572	0	99	96	98	97	97	99	586	0
Kendal Elder	Ohio State	Jan. 29, 2017	Ohio State	94	95	99	97	89	85	559	0	100	92	96	95	98	94	575	0
Alli Kissell	Ohio State	Jan. 29, 2017	Ohio State	98	94	97	98	92	92	571	0	98	96	97	97	96	99	583	0
Mark Matheny	Ohio State	Jan. 29, 2017	Ohio State	96	96	99	99	98	96	584	0	98	97	100	98	97	97	587	0
Patrick Sardo	Ohio State	Jan. 29, 2017	Ohio State	90	94	91	92	85	80	532	0	95	93	95	94	97	91	565	0
Michael Steinel	Ohio State	Jan. 29, 2017	Ohio State	99	98	99	98	91	97	582	0	98	100	100	100	99	98	595	0
Chrissy Thomas	Ohio State	Jan. 29, 2017	Ohio State	93	92	99	97	89	91	561	0	96	97	98	97	96	98	582	0
Rhiann Travis	Ohio State	Jan. 29, 2017	Ohio State	0	0	0	0	0	0	0	0	100	98	100	99	100	99	596	0
Bailey Urbach	Ohio State	Jan. 29, 2017	Ohio State	92	93	99	98	93	93	568	0	93	95	96	96	93	99	572	0
Brendan Whitaker	Ohio State	Jan. 29, 2017	Ohio State	95	87	98	97	89	92	558	0	97	96	98	94	93	96	574	0
Quintin Wotring	Ohio State	Jan. 29, 2017	Ohio State	93	94	97	100	90	91	565	0	95	94	93	97	96	92	567	0
Soren Butler	Alaska Fairbanks	Feb. 2, 2017	Nebraska	96	94	98	100	96	94	578	0	96	99	99	99	100	98	591	0
Liam Eberhart	Alaska Fairbanks	Feb. 2, 2017	Nebraska	0	0	0	0	0	0	0	0	0	0	0	0	0	0	0	0
Amy Gentry	Alaska Fairbanks	Feb. 2, 2017	Nebraska	96	97	95	98	94	95	575	0	98	96	96	97	97	99	583	0
Luke Johnson	Alaska Fairbanks	Feb. 2, 2017	Nebraska	98	96	98	98	95	97	582	0	97	99	100	99	98	98	591	0
Sagen Maddalena	Alaska Fairbanks	Feb. 2, 2017	Nebraska	100	98	100	99	96	98	591	0	99	100	100	100	98	99	596	0
Grace Nelson	Alaska Fairbanks	Feb. 2, 2017	Nebraska	0	0	0	0	0	0	0	0	0	0	0	0	0	0	0	0
JT Schnering	Alaska Fairbanks	Feb. 2, 2017	Nebraska	94	95	97	100	96	91	573	0	97	95	97	97	98	96	580	0
Robert Scott	Alaska Fairbanks	Feb. 2, 2017	Nebraska	92	90	99	100	88	95	564	0	98	96	99	98	97	99	587	0
Nathan Taylor	Alaska Fairbanks	Feb. 2, 2017	Nebraska	0	0	0	0	0	0	0	0	0	0	0	0	0	0	0	0
Katie Brown	Nebraska	Feb. 2, 2017	Nebraska	94	93	97	97	88	88	557	0	96	96	95	94	93	95	569	0
Jaycee Carter	Nebraska	Feb. 2, 2017	Nebraska	93	94	98	97	93	89	564	0	99	99	98	99	99	99	593	0
Dacotah Faught	Nebraska	Feb. 2, 2017	Nebraska	96	92	99	100	97	94	578	0	98	99	99	100	99	99	594	0
Kayla Gadeken	Nebraska	Feb. 2, 2017	Nebraska	94	96	97	99	95	94	575	0	98	98	99	95	97	97	584	0
Maddie Korthas	Nebraska	Feb. 2, 2017	Nebraska	86	92	95	98	93	88	552	0	96	97	96	97	100	97	583	0
Rachel Martin	Nebraska	Feb. 2, 2017	Nebraska	95	98	100	99	97	93	582	0	97	97	97	98	98	97	584	0
Jordan Miller	Nebraska	Feb. 2, 2017	Nebraska	0	0	0	0	0	0	0	0	0	0	0	0	0	0	0	0
Samantha Peterson	Nebraska	Feb. 2, 2017	Nebraska	95	95	99	99	98	96	582	0	99	100	99	99	97	98	592	0
Nina Radulovic	Nebraska	Feb. 2, 2017	Nebraska	99	96	99	97	90	93	574	0	96	96	98	99	100	99	588	0
Sarah Sutton	Nebraska	Feb. 2, 2017	Nebraska	95	94	99	96	82	92	558	0	98	98	97	98	98	97	586	0
Hannah Virga	Nebraska	Feb. 2, 2017	Nebraska	97	94	97	96	90	89	563	0	96	98	98	98	97	100	587	0
Rachel Yager	Nebraska	Feb. 2, 2017	Nebraska	96	94	98	98	90	94	570	0	94	97	94	94	95	93	567	0
Seth Baker	Morehead St.	Feb. 3, 2017	Morehead St.	97	97	97	100	91	91	573	0	0	0	0	0	0	0	0	0
Brandon Bryer	Morehead St.	Feb. 3, 2017	Morehead St.	94	95	98	98	93	95	573	0	0	0	0	0	0	0	0	0
Siarra Crum	Morehead St.	Feb. 3, 2017	Morehead St.	0	0	0	0	0	0	0	0	98	99	97	98	96	99	587	0
Sarah Fink	Morehead St.	Feb. 3, 2017	Morehead St.	0	0	0	0	0	0	0	0	0	0	0	0	0	0	0	0
Joe Fischer	Morehead St.	Feb. 3, 2017	Morehead St.	100	96	97	100	92	88	573	0	91	97	99	97	94	96	574	0
Dan Hall	Morehead St.	Feb. 3, 2017	Morehead St.	94	97	97	98	88	88	562	0	0	0	0	0	0	0	0	0
Jesse Moyer	Morehead St.	Feb. 3, 2017	Morehead St.	0	0	0	0	0	0	0	0	94	99	97	98	96	98	582	0
Alexa Potts	Morehead St.	Feb. 3, 2017	Morehead St.	94	97	97	99	91	95	573	0	98	99	98	96	99	95	585	0
Karly Potts	Morehead St.	Feb. 3, 2017	Morehead St.	0	0	0	0	0	0	0	0	94	97	100	100	98	97	586	0
Melanie West	Morehead St.	Feb. 3, 2017	Morehead St.	0	0	0	0	0	0	0	0	0	0	0	0	0	0	0	0
Haley Wilson	Morehead St.	Feb. 3, 2017	Morehead St.	0	0	0	0	0	0	0	0	0	0	0	0	0	0	0	0
Bobby Broadstreet	Murray St.	Feb. 3, 2017	Morehead St.	98	95	98	99	95	93	578	0	98	97	99	97	98	98	587	0
Meike Drewell	Murray St.	Feb. 3, 2017	Morehead St.	0	0	0	0	0	0	0	0	0	0	0	0	0	0	0	0
Ben Estes	Murray St.	Feb. 3, 2017	Morehead St.	95	97	98	100	95	93	578	0	0	0	0	0	0	0	0	0
Shelby Huber	Murray St.	Feb. 3, 2017	Morehead St.	0	0	0	0	0	0	0	0	0	0	0	0	0	0	0	0
Mackenzie Martin	Murray St.	Feb. 3, 2017	Morehead St.	94	96	99	96	95	96	576	0	98	98	100	98	99	99	592	0
Ivan Roe	Murray St.	Feb. 3, 2017	Morehead St.	97	99	99	98	96	98	587	0	98	100	100	99	99	98	594	0
Barbara Schlapfer	Murray St.	Feb. 3, 2017	Morehead St.	95	95	98	98	93	93	572	0	97	100	100	98	97	99	591	0
Alathea Sellars	Murray St.	Feb. 3, 2017	Morehead St.	0	0	0	0	0	0	0	0	100	100	99	99	98	98	594	0
Eric Sloan	Murray St.	Feb. 3, 2017	Morehead St.	0	0	0	0	0	0	0	0	0	0	0	0	0	0	0	0
Alex Bapties	UT Martin	Feb. 3, 2017	Morehead St.	0	0	0	0	0	0	0	0	0	0	0	0	0	0	0	0
Brigitte Curcio	UT Martin	Feb. 3, 2017	Morehead St.	95	94	98	96	90	95	568	0	96	97	96	98	95	98	580	0
Andre Delcalzo	UT Martin	Feb. 3, 2017	Morehead St.	0	0	0	0	0	0	0	0	0	0	0	0	0	0	0	0
Logan Hunt	UT Martin	Feb. 3, 2017	Morehead St.	92	92	97	96	95	88	560	0	94	99	95	97	91	92	568	0
Kaitlin Korinek	UT Martin	Feb. 3, 2017	Morehead St.	95	97	93	97	98	92	572	0	96	97	99	97	98	99	586	0
Joe Martin	UT Martin	Feb. 3, 2017	Morehead St.	99	93	100	99	95	93	579	0	98	96	95	99	100	93	581	0
Alex Tamboli	UT Martin	Feb. 3, 2017	Morehead St.	93	94	97	98	89	93	564	0	95	94	96	94	99	92	570	0
Hunter Behrends	Jacksonville St.	Feb. 3, 2017	Morehead St.	0	0	0	0	0	0	0	0	0	0	0	0	0	0	0	0
Austin Cock	Jacksonville St.	Feb. 3, 2017	Morehead St.	0	0	0	0	0	0	0	0	98	98	96	96	98	97	583	0
Anika Corsi	Jacksonville St.	Feb. 3, 2017	Morehead St.	0	0	0	0	0	0	0	0	0	0	0	0	0	0	0	0
Trace Haynes	Jacksonville St.	Feb. 3, 2017	Morehead St.	0	0	0	0	0	0	0	0	0	0	0	0	0	0	0	0
Brandon Henson	Jacksonville St.	Feb. 3, 2017	Morehead St.	0	0	0	0	0	0	0	0	0	0	0	0	0	0	0	0
Brandon Muske	Jacksonville St.	Feb. 3, 2017	Morehead St.	97	99	96	97	93	95	577	0	98	98	96	99	98	99	588	0
Kyle Ordille	Jacksonville St.	Feb. 3, 2017	Morehead St.	0	0	0	0	0	0	0	0	0	0	0	0	0	0	0	0
Carleigh Peters	Jacksonville St.	Feb. 3, 2017	Morehead St.	0	0	0	0	0	0	0	0	97	97	98	97	94	92	575	0
Garrett Rabel	Jacksonville St.	Feb. 3, 2017	Morehead St.	0	0	0	0	0	0	0	0	0	0	0	0	0	0	0	0
Tyler Ramos	Jacksonville St.	Feb. 3, 2017	Morehead St.	0	0	0	0	0	0	0	0	0	0	0	0	0	0	0	0
Mekenna Richardson	Jacksonville St.	Feb. 3, 2017	Morehead St.	96	95	97	97	97	96	578	0	100	99	96	98	99	99	591	0
Carter Santrock	Jacksonville St.	Feb. 3, 2017	Morehead St.	95	92	95	99	92	92	565	0	99	96	97	100	99	96	587	0
Zach Schmidt	Jacksonville St.	Feb. 3, 2017	Morehead St.	93	93	97	98	94	96	571	0	0	0	0	0	0	0	0	0
David Sink	Jacksonville St.	Feb. 3, 2017	Morehead St.	95	95	99	99	91	93	572	0	0	0	0	0	0	0	0	0
Erin Bell	UT Martin (W)	Feb. 3, 2017	Morehead St.	0	0	0	0	0	0	0	0	0	0	0	0	0	0	0	0
Ashley Coots	UT Martin (W)	Feb. 3, 2017	Morehead St.	95	95	96	98	91	91	566	0	95	95	97	92	92	91	562	0
Lindsey Flint	UT Martin (W)	Feb. 3, 2017	Morehead St.	0	0	0	0	0	0	0	0	95	93	94	92	92	94	560	0
Amanda Mayo	UT Martin (W)	Feb. 3, 2017	Morehead St.	0	0	0	0	0	0	0	0	0	0	0	0	0	0	0	0
Jennifer Plocinik	UT Martin (W)	Feb. 3, 2017	Morehead St.	92	91	97	99	89	89	557	0	95	94	98	95	96	96	574	0
Brianna Sawyers	UT Martin (W)	Feb. 3, 2017	Morehead St.	91	94	98	96	82	81	542	0	93	94	92	95	94	95	563	0
Alyson Sylvester	UT Martin (W)	Feb. 3, 2017	Morehead St.	85	97	95	91	93	88	549	0	93	96	94	94	95	94	566	0
Melissa Brizzi	Coast Guard	Feb. 4, 2017	MIT	0	0	0	0	0	0	0	0	0	0	0	0	0	0	0	0
Joseph Busching	Coast Guard	Feb. 4, 2017	MIT	0	0	0	0	0	0	0	0	88	90	94	86	86	87	531	0
Jacob Dupree	Coast Guard	Feb. 4, 2017	MIT	92	93	86	93	83	88	535	0	86	90	93	96	93	89	547	0
Randall Ford	Coast Guard	Feb. 4, 2017	MIT	91	91	93	91	90	84	540	0	92	90	94	95	95	94	560	0
Marshall Grant	Coast Guard	Feb. 4, 2017	MIT	86	86	93	95	88	83	531	0	88	90	93	91	91	95	548	0
Alexandria Harrington	Coast Guard	Feb. 4, 2017	MIT	0	0	0	0	0	0	0	0	0	0	0	0	0	0	0	0
Anthony Lee	Coast Guard	Feb. 4, 2017	MIT	0	0	0	0	0	0	0	0	0	0	0	0	0	0	0	0
Dylan Lorence	Coast Guard	Feb. 4, 2017	MIT	91	89	95	97	85	76	533	0	92	87	92	88	95	93	547	0
Kaden Nichols	Coast Guard	Feb. 4, 2017	MIT	0	0	0	0	0	0	0	0	86	89	89	91	90	89	534	0
Nicholas Paisker	Coast Guard	Feb. 4, 2017	MIT	92	96	91	95	88	94	556	0	98	98	95	96	95	96	578	0
Paul Raynolds	Coast Guard	Feb. 4, 2017	MIT	0	0	0	0	0	0	0	0	0	0	0	0	0	0	0	0
David Rose	Coast Guard	Feb. 4, 2017	MIT	80	87	90	92	76	68	493	0	86	90	89	86	88	89	528	0
Alaric Stone	Coast Guard	Feb. 4, 2017	MIT	0	0	0	0	0	0	0	0	89	95	93	87	90	93	547	0
Nyjah Turner	Coast Guard	Feb. 4, 2017	MIT	86	89	87	85	76	80	503	0	91	91	84	89	93	92	540	0
William Caruso	MIT	Feb. 4, 2017	MIT	0	0	0	0	0	0	0	0	0	0	0	0	0	0	0	0
Efraim Helman	MIT	Feb. 4, 2017	MIT	0	0	0	0	0	0	0	0	0	0	0	0	0	0	0	0
Yaakov Helman	MIT	Feb. 4, 2017	MIT	0	0	0	0	0	0	0	0	0	0	0	0	0	0	0	0
Jesus Herrera	MIT	Feb. 4, 2017	MIT	0	0	0	0	0	0	0	0	0	0	0	0	0	0	0	0
Alexander Laiman	MIT	Feb. 4, 2017	MIT	65	74	90	90	67	69	455	0	0	0	0	0	0	0	0	0
Gregory Lee	MIT	Feb. 4, 2017	MIT	0	0	0	0	0	0	0	0	0	0	0	0	0	0	0	0
Kelly Mathesius	MIT	Feb. 4, 2017	MIT	89	88	95	96	83	81	532	0	93	89	95	93	96	91	557	0
Elijah Miller	MIT	Feb. 4, 2017	MIT	61	79	67	78	62	69	416	0	89	84	77	72	79	83	484	0
Dylan Modesitt	MIT	Feb. 4, 2017	MIT	0	0	0	0	0	0	0	0	0	0	0	0	0	0	0	0
Kevin Ng	MIT	Feb. 4, 2017	MIT	0	0	0	0	0	0	0	0	0	0	0	0	0	0	0	0
Alex Pacheco	MIT	Feb. 4, 2017	MIT	85	86	93	97	69	70	500	0	84	87	84	86	89	89	519	0
Kevin Petrovic	MIT	Feb. 4, 2017	MIT	0	0	0	0	0	0	0	0	0	0	0	0	0	0	0	0
Thomas Rick	MIT	Feb. 4, 2017	MIT	86	84	87	89	75	75	496	0	91	84	87	85	89	86	522	0
Joel Solis	MIT	Feb. 4, 2017	MIT	0	0	0	0	0	0	0	0	84	90	88	91	94	91	538	0
Allison Auten	Citadel	Feb. 4, 2017	Citadel	94	88	96	97	90	83	548	0	100	96	98	95	96	95	580	0
Matthew Davenport	Citadel	Feb. 4, 2017	Citadel	87	91	97	94	94	89	552	0	94	96	96	93	94	92	565	0
Joseph Ferguson	Citadel	Feb. 4, 2017	Citadel	78	87	96	96	84	85	526	0	90	91	96	92	87	90	546	0
Morgan Long	Citadel	Feb. 4, 2017	Citadel	0	0	0	0	0	0	0	0	0	0	0	0	0	0	0	0
Alexander McAlear	Citadel	Feb. 4, 2017	Citadel	94	93	93	98	83	87	548	0	94	95	89	95	93	91	557	0
Patrick Meyer	Citadel	Feb. 4, 2017	Citadel	95	93	94	95	86	92	555	0	92	95	96	94	95	95	567	0
Richie Parra	Citadel	Feb. 4, 2017	Citadel	90	92	93	93	81	87	536	0	92	97	98	97	94	97	575	0
Colton Poole	Citadel	Feb. 4, 2017	Citadel	94	93	97	97	94	91	566	0	97	95	98	91	98	93	572	0
Tommy Simrill	Citadel	Feb. 4, 2017	Citadel	84	94	96	89	67	68	498	0	94	90	94	92	94	90	554	0
Zach Eisenberg	North Carolina St.	Feb. 4, 2017	Citadel	0	0	0	0	0	0	0	0	0	0	0	0	0	0	0	0
Caitlyn Ford	North Carolina St.	Feb. 4, 2017	Citadel	96	98	97	98	95	94	578	0	96	95	93	94	99	99	576	0
Sarah Hickey	North Carolina St.	Feb. 4, 2017	Citadel	0	0	0	0	0	0	0	0	0	0	0	0	0	0	0	0
Lucas Kozeniesky	North Carolina St.	Feb. 4, 2017	Citadel	95	98	99	100	96	97	585	0	97	100	99	98	99	97	590	0
Tyler Lefebvre	North Carolina St.	Feb. 4, 2017	Citadel	0	0	0	0	0	0	0	0	0	0	0	0	0	0	0	0
Will Marciniak	North Carolina St.	Feb. 4, 2017	Citadel	97	97	98	100	93	92	577	0	98	99	95	93	94	97	576	0
Derya Pekari	North Carolina St.	Feb. 4, 2017	Citadel	96	93	97	99	92	93	570	0	96	98	96	94	94	96	574	0
Lauren Phillips	North Carolina St.	Feb. 4, 2017	Citadel	98	95	98	97	99	95	582	0	100	98	98	99	97	100	592	0
Claire Spina	North Carolina St.	Feb. 4, 2017	Citadel	0	0	0	0	0	0	0	0	0	0	0	0	0	0	0	0
Cullen Wargo	North Carolina St.	Feb. 4, 2017	Citadel	0	0	0	0	0	0	0	0	0	0	0	0	0	0	0	0
George Williams	North Carolina St.	Feb. 4, 2017	Citadel	0	0	0	0	0	0	0	0	0	0	0	0	0	0	0	0
Claire Zanti	North Carolina St.	Feb. 4, 2017	Citadel	94	97	99	98	92	95	575	0	95	97	100	98	97	94	581	0
Andrew Abernathy	North Georgia	Feb. 4, 2017	Citadel	89	96	97	97	94	90	563	0	97	96	96	96	96	97	578	0
Eric Azotea	North Georgia	Feb. 4, 2017	Citadel	0	0	0	0	0	0	0	0	0	0	0	0	0	0	0	0
Ruthanne Conner	North Georgia	Feb. 4, 2017	Citadel	91	96	96	100	90	93	566	0	97	99	97	95	94	94	576	0
Lucas Gilliland	North Georgia	Feb. 4, 2017	Citadel	90	89	98	93	87	87	544	0	94	97	93	97	93	93	567	0
Maddie Godwin	North Georgia	Feb. 4, 2017	Citadel	0	0	0	0	0	0	0	0	0	0	0	0	0	0	0	0
Hannah Peevy	North Georgia	Feb. 4, 2017	Citadel	0	0	0	0	0	0	0	0	0	0	0	0	0	0	0	0
Jared Rice	North Georgia	Feb. 4, 2017	Citadel	0	0	0	0	0	0	0	0	0	0	0	0	0	0	0	0
Tobin Sanctuary	North Georgia	Feb. 4, 2017	Citadel	97	91	99	99	86	92	564	0	97	92	89	92	96	93	559	0
Brianna Shaw	North Georgia	Feb. 4, 2017	Citadel	97	93	95	96	94	93	568	0	94	93	96	94	97	94	568	0
Dakota Spivey	North Georgia	Feb. 4, 2017	Citadel	0	0	0	0	0	0	0	0	0	0	0	0	0	0	0	0
David Turner	North Georgia	Feb. 4, 2017	Citadel	91	96	92	97	89	87	552	0	98	96	95	96	96	93	574	0
Carli Cline	Citadel (W)	Feb. 4, 2017	Citadel	92	91	91	93	85	88	540	0	90	91	93	94	91	95	554	0
Brandi Duzz	Citadel (W)	Feb. 4, 2017	Citadel	94	83	94	97	80	77	525	0	90	92	91	93	90	91	547	0
Leah Fenwrick-Wallace	Citadel (W)	Feb. 4, 2017	Citadel	83	86	89	91	79	86	514	0	92	93	95	93	98	95	566	0
Shadonna Littlejohn	Citadel (W)	Feb. 4, 2017	Citadel	87	80	93	91	78	80	509	0	86	93	84	88	92	89	532	0
Tierra Price	Citadel (W)	Feb. 4, 2017	Citadel	79	84	86	85	76	75	485	0	87	85	97	89	87	83	528	0
Faith Totherow	Citadel (W)	Feb. 4, 2017	Citadel	83	92	98	94	87	82	536	0	87	92	89	90	94	89	541	0
Raven Wills	Citadel (W)	Feb. 4, 2017	Citadel	87	91	91	93	91	87	540	0	96	90	92	89	93	95	555	0
Allison Auten	Citadel	Feb. 4, 2017	Citadel	0	0	0	0	0	0	0	0	0	0	0	0	0	0	0	0
Matthew Davenport	Citadel	Feb. 4, 2017	Citadel	0	0	0	0	0	0	0	0	0	0	0	0	0	0	0	0
Joseph Ferguson	Citadel	Feb. 4, 2017	Citadel	0	0	0	0	0	0	0	0	0	0	0	0	0	0	0	0
Morgan Long	Citadel	Feb. 4, 2017	Citadel	0	0	0	0	0	0	0	0	0	0	0	0	0	0	0	0
Alexander McAlear	Citadel	Feb. 4, 2017	Citadel	0	0	0	0	0	0	0	0	0	0	0	0	0	0	0	0
Patrick Meyer	Citadel	Feb. 4, 2017	Citadel	0	0	0	0	0	0	0	0	0	0	0	0	0	0	0	0
Richie Parra	Citadel	Feb. 4, 2017	Citadel	0	0	0	0	0	0	0	0	0	0	0	0	0	0	0	0
Colton Poole	Citadel	Feb. 4, 2017	Citadel	0	0	0	0	0	0	0	0	0	0	0	0	0	0	0	0
Tommy Simrill	Citadel	Feb. 4, 2017	Citadel	0	0	0	0	0	0	0	0	0	0	0	0	0	0	0	0
Zach Eisenberg	North Carolina St.	Feb. 4, 2017	Citadel	0	0	0	0	0	0	0	0	0	0	0	0	0	0	0	0
Caitlyn Ford	North Carolina St.	Feb. 4, 2017	Citadel	0	0	0	0	0	0	0	0	0	0	0	0	0	0	0	0
Sarah Hickey	North Carolina St.	Feb. 4, 2017	Citadel	0	0	0	0	0	0	0	0	0	0	0	0	0	0	0	0
Lucas Kozeniesky	North Carolina St.	Feb. 4, 2017	Citadel	0	0	0	0	0	0	0	0	0	0	0	0	0	0	0	0
Tyler Lefebvre	North Carolina St.	Feb. 4, 2017	Citadel	0	0	0	0	0	0	0	0	0	0	0	0	0	0	0	0
Will Marciniak	North Carolina St.	Feb. 4, 2017	Citadel	0	0	0	0	0	0	0	0	0	0	0	0	0	0	0	0
Derya Pekari	North Carolina St.	Feb. 4, 2017	Citadel	0	0	0	0	0	0	0	0	0	0	0	0	0	0	0	0
Lauren Phillips	North Carolina St.	Feb. 4, 2017	Citadel	0	0	0	0	0	0	0	0	0	0	0	0	0	0	0	0
Claire Spina	North Carolina St.	Feb. 4, 2017	Citadel	0	0	0	0	0	0	0	0	0	0	0	0	0	0	0	0
Cullen Wargo	North Carolina St.	Feb. 4, 2017	Citadel	0	0	0	0	0	0	0	0	0	0	0	0	0	0	0	0
George Williams	North Carolina St.	Feb. 4, 2017	Citadel	0	0	0	0	0	0	0	0	0	0	0	0	0	0	0	0
Claire Zanti	North Carolina St.	Feb. 4, 2017	Citadel	0	0	0	0	0	0	0	0	0	0	0	0	0	0	0	0
Andrew Abernathy	North Georgia	Feb. 4, 2017	Citadel	0	0	0	0	0	0	0	0	0	0	0	0	0	0	0	0
Eric Azotea	North Georgia	Feb. 4, 2017	Citadel	0	0	0	0	0	0	0	0	0	0	0	0	0	0	0	0
Ruthanne Conner	North Georgia	Feb. 4, 2017	Citadel	0	0	0	0	0	0	0	0	0	0	0	0	0	0	0	0
Lucas Gilliland	North Georgia	Feb. 4, 2017	Citadel	0	0	0	0	0	0	0	0	0	0	0	0	0	0	0	0
Maddie Godwin	North Georgia	Feb. 4, 2017	Citadel	0	0	0	0	0	0	0	0	0	0	0	0	0	0	0	0
Hannah Peevy	North Georgia	Feb. 4, 2017	Citadel	0	0	0	0	0	0	0	0	0	0	0	0	0	0	0	0
Jared Rice	North Georgia	Feb. 4, 2017	Citadel	0	0	0	0	0	0	0	0	0	0	0	0	0	0	0	0
Tobin Sanctuary	North Georgia	Feb. 4, 2017	Citadel	0	0	0	0	0	0	0	0	0	0	0	0	0	0	0	0
Brianna Shaw	North Georgia	Feb. 4, 2017	Citadel	0	0	0	0	0	0	0	0	0	0	0	0	0	0	0	0
Dakota Spivey	North Georgia	Feb. 4, 2017	Citadel	0	0	0	0	0	0	0	0	0	0	0	0	0	0	0	0
David Turner	North Georgia	Feb. 4, 2017	Citadel	0	0	0	0	0	0	0	0	0	0	0	0	0	0	0	0
Carli Cline	Citadel (W)	Feb. 4, 2017	Citadel	0	0	0	0	0	0	0	0	0	0	0	0	0	0	0	0
Brandi Duzz	Citadel (W)	Feb. 4, 2017	Citadel	0	0	0	0	0	0	0	0	0	0	0	0	0	0	0	0
Leah Fenwrick-Wallace	Citadel (W)	Feb. 4, 2017	Citadel	0	0	0	0	0	0	0	0	0	0	0	0	0	0	0	0
Shadonna Littlejohn	Citadel (W)	Feb. 4, 2017	Citadel	0	0	0	0	0	0	0	0	0	0	0	0	0	0	0	0
Tierra Price	Citadel (W)	Feb. 4, 2017	Citadel	0	0	0	0	0	0	0	0	0	0	0	0	0	0	0	0
Faith Totherow	Citadel (W)	Feb. 4, 2017	Citadel	0	0	0	0	0	0	0	0	0	0	0	0	0	0	0	0
Raven Wills	Citadel (W)	Feb. 4, 2017	Citadel	0	0	0	0	0	0	0	0	0	0	0	0	0	0	0	0
Spencer Brandon	Air Force	Feb. 4, 2017	Ohio State	96	87	96	98	89	93	559	19	97	100	97	99	96	98	587	39
Spencer Cap	Air Force	Feb. 4, 2017	Ohio State	96	96	97	98	94	98	579	29	99	100	99	100	98	97	593	48
Kyle Cox	Air Force	Feb. 4, 2017	Ohio State	0	0	0	0	0	0	0	0	0	0	0	0	0	0	0	0
Ryan Jacobs	Air Force	Feb. 4, 2017	Ohio State	97	95	99	98	96	92	577	20	100	98	99	97	96	99	589	45
Noah Kwock	Air Force	Feb. 4, 2017	Ohio State	0	0	0	0	0	0	0	0	0	0	0	0	0	0	0	0
Nick Learn	Air Force	Feb. 4, 2017	Ohio State	94	92	98	98	90	96	568	22	97	98	100	98	97	97	587	37
Logan Ogden	Air Force	Feb. 4, 2017	Ohio State	97	94	99	99	91	94	574	25	99	99	99	99	99	100	595	49
Mary Simonton	Air Force	Feb. 4, 2017	Ohio State	0	0	0	0	0	0	0	0	0	0	0	0	0	0	0	0
Anna Weilbacher	Air Force	Feb. 4, 2017	Ohio State	96	100	98	98	94	93	579	27	98	96	98	99	99	96	586	36
Soren Butler	Alaska Fairbanks	Feb. 4, 2017	Ohio State	98	98	100	98	96	99	589	29	98	99	100	98	98	100	593	44
Liam Eberhart	Alaska Fairbanks	Feb. 4, 2017	Ohio State	0	0	0	0	0	0	0	0	0	0	0	0	0	0	0	0
Amy Gentry	Alaska Fairbanks	Feb. 4, 2017	Ohio State	96	97	100	94	94	92	573	22	98	94	99	96	98	97	582	31
Luke Johnson	Alaska Fairbanks	Feb. 4, 2017	Ohio State	93	98	99	100	95	94	579	28	98	100	98	99	99	97	591	39
Sagen Maddalena	Alaska Fairbanks	Feb. 4, 2017	Ohio State	100	98	100	100	94	97	589	38	100	99	100	99	99	100	597	46
Grace Nelson	Alaska Fairbanks	Feb. 4, 2017	Ohio State	0	0	0	0	0	0	0	0	0	0	0	0	0	0	0	0
JT Schnering	Alaska Fairbanks	Feb. 4, 2017	Ohio State	95	97	97	97	91	94	571	23	98	97	99	99	96	98	587	38
Robert Scott	Alaska Fairbanks	Feb. 4, 2017	Ohio State	92	94	99	99	94	93	571	26	98	99	99	100	100	98	594	46
Nathan Taylor	Alaska Fairbanks	Feb. 4, 2017	Ohio State	0	0	0	0	0	0	0	0	0	0	0	0	0	0	0	0
Rachel Benesh	Nevada	Feb. 4, 2017	Ohio State	94	93	98	98	98	94	575	16	97	98	98	98	99	98	588	37
Emily Capaul	Nevada	Feb. 4, 2017	Ohio State	90	98	98	97	91	93	567	16	99	98	100	97	98	99	591	43
Jared Crews	Nevada	Feb. 4, 2017	Ohio State	0	0	0	0	0	0	0	0	0	0	0	0	0	0	0	0
Maneva Gill	Nevada	Feb. 4, 2017	Ohio State	0	0	0	0	0	0	0	0	0	0	0	0	0	0	0	0
Sarah Jameson	Nevada	Feb. 4, 2017	Ohio State	92	91	98	96	96	93	566	20	99	98	100	99	96	100	592	44
Eli Larimer	Nevada	Feb. 4, 2017	Ohio State	97	94	99	98	93	96	577	25	97	99	98	99	99	99	591	47
Justin Nissen	Nevada	Feb. 4, 2017	Ohio State	95	93	98	100	88	95	569	25	99	98	98	98	94	96	583	32
Jami Sexton	Nevada	Feb. 4, 2017	Ohio State	0	0	0	0	0	0	0	0	0	0	0	0	0	0	0	0
Sara Tashima	Nevada	Feb. 4, 2017	Ohio State	0	0	0	0	0	0	0	0	0	0	0	0	0	0	0	0
Mitchell Van Patten	Nevada	Feb. 4, 2017	Ohio State	97	97	100	99	96	95	584	30	95	99	100	99	97	96	586	37
Deanna Binnie	Ohio State	Feb. 4, 2017	Ohio State	96	98	98	100	90	85	567	27	0	0	0	0	0	0	0	0
Josh Black	Ohio State	Feb. 4, 2017	Ohio State	96	93	99	98	91	93	570	21	99	99	99	98	95	98	588	36
Jacob Buchanan	Ohio State	Feb. 4, 2017	Ohio State	95	97	97	97	94	93	573	19	96	99	99	99	99	98	590	42
Drew Cheezum	Ohio State	Feb. 4, 2017	Ohio State	96	96	99	97	93	99	580	20	99	100	97	99	100	98	593	44
Anthony Cuozzo	Ohio State	Feb. 4, 2017	Ohio State	95	100	100	100	94	96	585	38	0	0	0	0	0	0	0	0
Kendal Elder	Ohio State	Feb. 4, 2017	Ohio State	0	0	0	0	0	0	0	0	96	97	99	93	95	98	578	35
Alli Kissell	Ohio State	Feb. 4, 2017	Ohio State	93	98	97	96	95	90	569	20	0	0	0	0	0	0	0	0
Mark Matheny	Ohio State	Feb. 4, 2017	Ohio State	96	97	97	97	92	92	571	22	100	98	99	99	99	98	593	43
Patrick Sardo	Ohio State	Feb. 4, 2017	Ohio State	0	0	0	0	0	0	0	0	0	0	0	0	0	0	0	0
Michael Steinel	Ohio State	Feb. 4, 2017	Ohio State	97	98	99	99	95	95	583	33	99	99	99	100	97	99	593	45
Chrissy Thomas	Ohio State	Feb. 4, 2017	Ohio State	0	0	0	0	0	0	0	0	96	96	97	98	97	98	582	29
Rhiann Travis	Ohio State	Feb. 4, 2017	Ohio State	96	98	98	98	97	97	584	27	100	99	99	97	99	98	592	0
Bailey Urbach	Ohio State	Feb. 4, 2017	Ohio State	97	93	98	96	91	90	565	17	0	0	0	0	0	0	0	0
Brendan Whitaker	Ohio State	Feb. 4, 2017	Ohio State	0	0	0	0	0	0	0	0	94	92	98	99	98	93	574	30
Quintin Wotring	Ohio State	Feb. 4, 2017	Ohio State	0	0	0	0	0	0	0	0	97	97	97	95	92	96	574	33
Nicholle Benedict	TCU	Feb. 4, 2017	Ohio State	0	0	0	0	0	0	0	0	0	0	0	0	0	0	0	0
Katie Bridges	TCU	Feb. 4, 2017	Ohio State	0	0	0	0	0	0	0	0	0	0	0	0	0	0	0	0
Rachel Garner	TCU	Feb. 4, 2017	Ohio State	100	97	100	100	95	94	586	34	99	99	98	99	99	100	594	43
Ariana Grabowski	TCU	Feb. 4, 2017	Ohio State	99	98	99	98	96	96	586	28	98	95	99	97	98	100	587	40
Emily Haag	TCU	Feb. 4, 2017	Ohio State	0	0	0	0	0	0	0	0	0	0	0	0	0	0	0	0
Nicole Hankey	TCU	Feb. 4, 2017	Ohio State	94	98	98	100	96	95	581	23	0	0	0	0	0	0	0	0
Rachel Kimbell	TCU	Feb. 4, 2017	Ohio State	0	0	0	0	0	0	0	0	0	0	0	0	0	0	0	0
Sally Li	TCU	Feb. 4, 2017	Ohio State	98	98	98	97	96	93	580	29	98	100	100	100	99	99	596	49
Casey Lutz	TCU	Feb. 4, 2017	Ohio State	96	99	99	99	99	96	588	33	99	99	97	100	100	100	595	48
Mindy Miles	TCU	Feb. 4, 2017	Ohio State	92	97	98	100	98	98	583	35	100	100	100	100	98	100	598	55
Catherine Miller	TCU	Feb. 4, 2017	Ohio State	0	0	0	0	0	0	0	0	98	99	99	97	99	100	592	45
Meraleigh Randle	TCU	Feb. 4, 2017	Ohio State	0	0	0	0	0	0	0	0	0	0	0	0	0	0	0	0
Barrett Ray	TCU	Feb. 4, 2017	Ohio State	0	0	0	0	0	0	0	0	0	0	0	0	0	0	0	0
Jessica Kinder	UTEP	Feb. 4, 2017	Ohio State	0	0	0	0	0	0	0	0	98	98	99	100	98	99	592	42
Abby Monique	UTEP	Feb. 4, 2017	Ohio State	97	94	96	97	79	85	548	16	95	98	98	98	95	97	581	32
Maranda Nelson	UTEP	Feb. 4, 2017	Ohio State	96	96	95	91	90	89	557	17	96	96	95	94	98	95	574	26
Bailey Powell	UTEP	Feb. 4, 2017	Ohio State	90	93	99	98	84	86	550	15	99	98	99	98	99	99	592	40
Mara Rouse	UTEP	Feb. 4, 2017	Ohio State	92	96	97	96	91	96	568	19	95	95	97	95	98	97	577	32
Rachael Schoenrock	UTEP	Feb. 4, 2017	Ohio State	94	96	99	98	97	90	574	29	95	97	92	98	97	97	576	27
Haylee Schoenrock	UTEP	Feb. 4, 2017	Ohio State	0	0	0	0	0	0	0	0	0	0	0	0	0	0	0	0
Monthserrat Serna	UTEP	Feb. 4, 2017	Ohio State	0	0	0	0	0	0	0	0	0	0	0	0	0	0	0	0
Kealie Engels	Wofford	Feb. 4, 2017	Wofford	0	0	0	0	0	0	0	0	0	0	0	0	0	0	0	0
Seth Flanagan	Wofford	Feb. 4, 2017	Wofford	0	0	0	0	0	0	0	0	85	93	92	90	92	89	541	0
Cierra Holcombe	Wofford	Feb. 4, 2017	Wofford	0	0	0	0	0	0	0	0	94	94	92	92	95	97	564	0
Carson Howell	Wofford	Feb. 4, 2017	Wofford	0	0	0	0	0	0	0	0	0	0	0	0	0	0	0	0
Nicholas Hunter	Wofford	Feb. 4, 2017	Wofford	0	0	0	0	0	0	0	0	92	93	96	93	92	91	557	0
Zachry Hunter	Wofford	Feb. 4, 2017	Wofford	0	0	0	0	0	0	0	0	88	90	88	94	89	92	541	0
Reid Schuster	Wofford	Feb. 4, 2017	Wofford	0	0	0	0	0	0	0	0	87	86	95	91	88	86	533	0
Sarah Banks	Alabama Birmingham	Feb. 4, 2017	Wofford	0	0	0	0	0	0	0	0	93	95	95	97	93	93	566	0
Steven Bugg	Alabama Birmingham	Feb. 4, 2017	Wofford	0	0	0	0	0	0	0	0	0	0	0	0	0	0	0	0
Selina Curren	Alabama Birmingham	Feb. 4, 2017	Wofford	0	0	0	0	0	0	0	0	0	0	0	0	0	0	0	0
Lindsey Hill	Alabama Birmingham	Feb. 4, 2017	Wofford	0	0	0	0	0	0	0	0	0	0	0	0	0	0	0	0
Isaac King	Alabama Birmingham	Feb. 4, 2017	Wofford	0	0	0	0	0	0	0	0	0	0	0	0	0	0	0	0
Kristie Lloyd	Alabama Birmingham	Feb. 4, 2017	Wofford	0	0	0	0	0	0	0	0	90	90	74	88	80	89	511	0
Logan Short	Alabama Birmingham	Feb. 4, 2017	Wofford	0	0	0	0	0	0	0	0	0	0	0	0	0	0	0	0
Mallory Sisk	Alabama Birmingham	Feb. 4, 2017	Wofford	0	0	0	0	0	0	0	0	0	0	0	0	0	0	0	0
Micah Smith	Alabama Birmingham	Feb. 4, 2017	Wofford	0	0	0	0	0	0	0	0	0	0	0	0	0	0	0	0
Emily Stover	Alabama Birmingham	Feb. 4, 2017	Wofford	0	0	0	0	0	0	0	0	91	90	93	92	94	90	550	0
Ella Von Canon	Alabama Birmingham	Feb. 4, 2017	Wofford	0	0	0	0	0	0	0	0	91	92	87	91	87	93	541	0
Lilly Vonderau	Alabama Birmingham	Feb. 4, 2017	Wofford	0	0	0	0	0	0	0	0	90	92	94	95	95	94	560	0
Lauryn Cinadr	Akron	Feb. 4, 2017	Kentucky	90	91	95	100	93	91	560	0	97	99	100	98	97	97	588	0
Alex Fedorko	Akron	Feb. 4, 2017	Kentucky	0	0	0	0	0	0	0	0	0	0	0	0	0	0	0	0
Sydney Goldschlag	Akron	Feb. 4, 2017	Kentucky	0	0	0	0	0	0	0	0	0	0	0	0	0	0	0	0
Rebecca Green	Akron	Feb. 4, 2017	Kentucky	96	91	92	90	89	92	550	0	97	98	97	97	97	95	581	0
Julia Hatch	Akron	Feb. 4, 2017	Kentucky	96	98	95	96	95	91	571	0	97	96	100	95	96	97	581	0
Anthony Jackson	Akron	Feb. 4, 2017	Kentucky	93	94	98	99	96	90	570	0	97	99	93	97	97	96	579	0
Kera Kaufman	Akron	Feb. 4, 2017	Kentucky	94	96	96	100	93	92	571	0	96	95	96	98	100	98	583	0
Joshua Kovach	Akron	Feb. 4, 2017	Kentucky	95	91	96	97	97	95	571	0	97	97	97	96	97	95	579	0
Caleb Lloyd	Akron	Feb. 4, 2017	Kentucky	98	98	100	99	95	89	579	0	96	95	97	99	98	94	579	0
Danielle Makucevich	Akron	Feb. 4, 2017	Kentucky	0	0	0	0	0	0	0	0	0	0	0	0	0	0	0	0
Kris Mantel	Akron	Feb. 4, 2017	Kentucky	0	0	0	0	0	0	0	0	0	0	0	0	0	0	0	0
Brent Morgan	Akron	Feb. 4, 2017	Kentucky	0	0	0	0	0	0	0	0	0	0	0	0	0	0	0	0
Connor O'Mara	Akron	Feb. 4, 2017	Kentucky	95	93	99	98	97	92	574	0	99	96	97	96	95	95	578	0
Marlee Reynolds	Akron	Feb. 4, 2017	Kentucky	0	0	0	0	0	0	0	0	0	0	0	0	0	0	0	0
Sean Roehrs	Akron	Feb. 4, 2017	Kentucky	0	0	0	0	0	0	0	0	0	0	0	0	0	0	0	0
Zach Strohl	Akron	Feb. 4, 2017	Kentucky	97	97	100	100	95	94	583	0	96	99	99	99	100	97	590	0
Cierra Terrizzi	Akron	Feb. 4, 2017	Kentucky	96	97	97	96	91	90	567	0	98	100	96	99	97	100	590	0
Hayley Carroll	Ole Miss	Feb. 4, 2017	Kentucky	96	94	96	97	88	95	566	0	98	99	95	99	98	99	588	0
Harley Gardner	Ole Miss	Feb. 4, 2017	Kentucky	93	96	98	100	96	93	576	0	97	98	98	97	96	99	585	0
Jess Haig	Ole Miss	Feb. 4, 2017	Kentucky	94	97	98	100	91	97	577	0	98	96	100	97	99	97	587	0
Alana Kelly	Ole Miss	Feb. 4, 2017	Kentucky	96	94	99	97	90	91	567	0	95	97	97	98	99	96	582	0
Randi Loudin	Ole Miss	Feb. 4, 2017	Kentucky	90	89	100	99	91	94	563	0	94	97	96	97	93	97	574	0
Marina Noble	Ole Miss	Feb. 4, 2017	Kentucky	0	0	0	0	0	0	0	0	0	0	0	0	0	0	0	0
Samantha Sandifer	Ole Miss	Feb. 4, 2017	Kentucky	96	92	97	96	81	91	553	0	95	98	98	95	98	97	581	0
Kristyn Trump	Ole Miss	Feb. 4, 2017	Kentucky	95	96	98	98	87	89	563	0	96	93	99	97	96	96	577	0
Jillian Tyler	Ole Miss	Feb. 4, 2017	Kentucky	96	97	98	99	88	95	573	0	98	97	97	98	97	97	584	0
Ali Weisz	Ole Miss	Feb. 4, 2017	Kentucky	96	96	99	97	94	95	577	0	97	99	99	100	99	98	592	0
Melissa Brizzi	Coast Guard	Feb. 5, 2017	MIT	0	0	0	0	0	0	0	0	0	0	0	0	0	0	0	0
Joseph Busching	Coast Guard	Feb. 5, 2017	MIT	0	0	0	0	0	0	0	0	86	91	89	91	87	92	536	10
Jacob Dupree	Coast Guard	Feb. 5, 2017	MIT	86	86	96	92	77	83	520	9	92	92	93	91	94	87	549	12
Randall Ford	Coast Guard	Feb. 5, 2017	MIT	86	88	98	95	88	89	544	14	94	91	92	94	93	94	558	19
Marshall Grant	Coast Guard	Feb. 5, 2017	MIT	86	84	97	97	79	80	523	11	85	92	90	89	93	94	543	13
Alexandria Harrington	Coast Guard	Feb. 5, 2017	MIT	0	0	0	0	0	0	0	0	0	0	0	0	0	0	0	0
Anthony Lee	Coast Guard	Feb. 5, 2017	MIT	0	0	0	0	0	0	0	0	0	0	0	0	0	0	0	0
Dylan Lorence	Coast Guard	Feb. 5, 2017	MIT	90	96	96	97	84	85	548	8	91	89	89	91	95	84	539	7
Kaden Nichols	Coast Guard	Feb. 5, 2017	MIT	0	0	0	0	0	0	0	0	95	89	93	93	87	94	551	17
Nicholas Paisker	Coast Guard	Feb. 5, 2017	MIT	92	89	95	95	88	87	546	12	100	95	96	99	97	94	581	33
Paul Raynolds	Coast Guard	Feb. 5, 2017	MIT	0	0	0	0	0	0	0	0	0	0	0	0	0	0	0	0
David Rose	Coast Guard	Feb. 5, 2017	MIT	88	84	88	89	67	74	490	5	86	89	90	86	87	85	523	8
Alaric Stone	Coast Guard	Feb. 5, 2017	MIT	0	0	0	0	0	0	0	0	93	90	85	92	91	91	542	17
Nyjah Turner	Coast Guard	Feb. 5, 2017	MIT	87	90	92	87	78	81	515	3	94	86	90	86	83	86	525	7
William Caruso	MIT	Feb. 5, 2017	MIT	77	80	92	89	71	82	491	5	86	80	85	88	90	81	510	8
Efraim Helman	MIT	Feb. 5, 2017	MIT	72	74	91	89	52	61	439	2	81	75	81	80	81	78	476	3
Yaakov Helman	MIT	Feb. 5, 2017	MIT	70	55	74	69	64	63	395	2	0	0	0	0	0	0	0	0
Jesus Herrera	MIT	Feb. 5, 2017	MIT	0	0	0	0	0	0	0	0	0	0	0	0	0	0	0	0
Alexander Laiman	MIT	Feb. 5, 2017	MIT	0	0	0	0	0	0	0	0	0	0	0	0	0	0	0	0
Gregory Lee	MIT	Feb. 5, 2017	MIT	0	0	0	0	0	0	0	0	0	0	0	0	0	0	0	0
Kelly Mathesius	MIT	Feb. 5, 2017	MIT	92	89	91	96	75	79	522	12	91	87	97	90	94	95	554	19
Elijah Miller	MIT	Feb. 5, 2017	MIT	79	75	81	85	80	69	469	3	83	83	77	86	78	81	488	10
Dylan Modesitt	MIT	Feb. 5, 2017	MIT	0	0	0	0	0	0	0	0	0	0	0	0	0	0	0	0
Kevin Ng	MIT	Feb. 5, 2017	MIT	0	0	0	0	0	0	0	0	0	0	0	0	0	0	0	0
Alex Pacheco	MIT	Feb. 5, 2017	MIT	83	83	92	82	67	76	483	6	85	87	87	94	83	94	530	10
Kevin Petrovic	MIT	Feb. 5, 2017	MIT	0	0	0	0	0	0	0	0	0	0	0	0	0	0	0	0
Thomas Rick	MIT	Feb. 5, 2017	MIT	82	85	93	91	82	70	503	4	85	77	86	89	86	87	510	4
Joel Solis	MIT	Feb. 5, 2017	MIT	0	0	0	0	0	0	0	0	92	88	87	87	81	89	524	11
Nathan Brewer	Army	Feb. 5, 2017	Army	95	98	99	99	95	96	582	31	99	98	93	96	98	96	580	32
Emiliano Concha-Toro	Army	Feb. 5, 2017	Army	92	95	99	99	92	93	570	24	96	96	96	98	98	94	578	32
Ethan Cook	Army	Feb. 5, 2017	Army	89	95	100	97	86	90	557	20	95	97	98	97	98	94	579	31
Danielle Cuomo	Army	Feb. 5, 2017	Army	95	97	98	98	97	96	581	28	99	97	100	98	99	98	591	42
Maggie Ehmann	Army	Feb. 5, 2017	Army	91	92	95	94	94	93	559	15	97	92	98	93	95	95	570	23
Maddy Erikson	Army	Feb. 5, 2017	Army	95	95	99	96	95	91	571	22	95	96	98	95	97	99	580	34
Mike Garner	Army	Feb. 5, 2017	Army	93	93	94	98	91	93	562	18	94	95	95	94	96	92	566	21
Nick Kanellis	Army	Feb. 5, 2017	Army	87	88	96	93	91	90	545	11	95	95	95	96	96	96	573	32
Marvin Lewis	Army	Feb. 5, 2017	Army	97	98	99	100	98	96	588	35	100	98	98	98	97	98	589	38
Rhianna Lichtenthal	Army	Feb. 5, 2017	Army	92	93	98	97	88	90	558	15	98	95	96	99	90	95	573	27
Libby Mostert	Army	Feb. 5, 2017	Army	96	95	97	97	90	90	565	21	95	96	95	95	97	97	575	31
Sarah Nakata	Army	Feb. 5, 2017	Army	0	0	0	0	0	0	0	0	0	0	0	0	0	0	0	0
Payne Nunn	Army	Feb. 5, 2017	Army	95	97	98	97	90	91	568	20	96	98	95	98	98	99	584	34
Allen Solida	Army	Feb. 5, 2017	Army	98	96	97	98	96	92	577	23	98	98	96	97	96	94	579	29
Andrew Solomonides	Army	Feb. 5, 2017	Army	92	94	97	100	91	92	566	16	94	95	97	96	96	95	573	25
Lucas Figi	Navy	Feb. 5, 2017	Army	97	91	97	98	86	77	546	20	89	98	94	97	95	96	569	27
Maggie Guetersloh	Navy	Feb. 5, 2017	Army	0	0	0	0	0	0	0	0	0	0	0	0	0	0	0	0
Amy Hammer	Navy	Feb. 5, 2017	Army	97	95	94	96	89	89	560	18	97	94	96	95	100	98	580	32
Daniel Jonas	Navy	Feb. 5, 2017	Army	98	96	97	99	96	97	583	33	98	99	94	100	99	97	587	39
Kestrel Kuhne	Navy	Feb. 5, 2017	Army	91	92	100	98	91	91	563	16	97	98	96	97	98	97	583	36
Alex Muzzioli	Navy	Feb. 5, 2017	Army	96	95	100	97	97	91	576	24	100	97	98	98	98	96	587	38
Brandon Pippin	Navy	Feb. 5, 2017	Army	0	0	0	0	0	0	0	0	98	95	95	96	96	98	578	23
Nash Richardson	Navy	Feb. 5, 2017	Army	88	94	100	98	85	91	556	11	96	95	99	99	94	98	581	27
Thomas Sarant	Navy	Feb. 5, 2017	Army	89	89	100	96	88	92	554	17	97	100	98	98	97	98	588	45
Josh Watson	Navy	Feb. 5, 2017	Army	96	95	98	99	95	93	576	25	96	97	98	97	100	97	585	37
Hayley Carroll	Ole Miss	Feb. 11, 2017	Memphis	96	94	97	99	92	93	571	0	97	95	96	94	98	98	578	0
Harley Gardner	Ole Miss	Feb. 11, 2017	Memphis	93	95	99	100	97	94	578	0	98	98	98	98	96	98	586	0
Jess Haig	Ole Miss	Feb. 11, 2017	Memphis	94	95	98	97	93	98	575	0	98	98	97	100	97	99	589	0
Alana Kelly	Ole Miss	Feb. 11, 2017	Memphis	96	96	97	95	89	92	565	0	96	100	96	95	95	97	579	0
Randi Loudin	Ole Miss	Feb. 11, 2017	Memphis	91	89	100	100	95	93	568	0	98	93	98	97	93	94	573	0
Marina Noble	Ole Miss	Feb. 11, 2017	Memphis	0	0	0	0	0	0	0	0	0	0	0	0	0	0	0	0
Samantha Sandifer	Ole Miss	Feb. 11, 2017	Memphis	94	91	96	94	86	87	548	0	96	95	94	94	98	96	573	0
Kristyn Trump	Ole Miss	Feb. 11, 2017	Memphis	92	96	95	97	92	94	566	0	98	96	97	96	96	95	578	0
Jillian Tyler	Ole Miss	Feb. 11, 2017	Memphis	98	90	97	100	93	94	572	0	97	98	96	95	98	94	578	0
Ali Weisz	Ole Miss	Feb. 11, 2017	Memphis	96	91	98	98	97	93	573	0	100	97	99	100	98	96	590	0
Jack Berhorst	Memphis	Feb. 11, 2017	Memphis	95	97	98	99	89	88	566	0	98	98	95	97	98	95	581	0
Haylea Broughton	Memphis	Feb. 11, 2017	Memphis	97	95	95	95	89	93	564	0	98	96	95	97	99	94	579	0
Levi Clark	Memphis	Feb. 11, 2017	Memphis	94	97	99	98	93	93	574	0	97	96	96	97	98	98	582	0
Leighton Dempster	Memphis	Feb. 11, 2017	Memphis	96	96	96	96	88	89	561	0	98	98	96	99	98	97	586	0
Makennon Doran	Memphis	Feb. 11, 2017	Memphis	0	0	0	0	0	0	0	0	0	0	0	0	0	0	0	0
Amberlie Ezell	Memphis	Feb. 11, 2017	Memphis	97	90	97	96	94	93	567	0	97	98	97	96	98	96	582	0
Amy Fister	Memphis	Feb. 11, 2017	Memphis	97	93	98	100	92	95	575	0	96	99	98	97	98	98	586	0
Eli Rischling	Memphis	Feb. 11, 2017	Memphis	93	94	96	97	86	90	556	0	91	92	96	95	97	98	569	0
Abby Votava	Memphis	Feb. 11, 2017	Memphis	94	85	93	96	93	94	555	0	95	97	90	93	93	96	564	0
Nicholle Benedict	TCU	Feb. 11, 2017	TCU	94	91	96	96	88	87	552	0	96	96	98	94	97	97	578	0
Katie Bridges	TCU	Feb. 11, 2017	TCU	98	92	100	100	87	90	567	0	95	98	97	97	95	94	576	0
Rachel Garner	TCU	Feb. 11, 2017	TCU	99	95	98	99	95	96	582	0	99	100	100	99	100	99	597	0
Ariana Grabowski	TCU	Feb. 11, 2017	TCU	99	99	99	98	98	93	586	0	99	96	99	100	98	98	590	0
Emily Haag	TCU	Feb. 11, 2017	TCU	95	94	100	99	85	91	564	0	94	98	94	97	95	97	575	0
Nicole Hankey	TCU	Feb. 11, 2017	TCU	98	100	99	98	97	92	584	0	100	99	99	100	100	99	597	0
Rachel Kimbell	TCU	Feb. 11, 2017	TCU	89	95	98	99	93	92	566	0	97	98	97	98	97	97	584	0
Sally Li	TCU	Feb. 11, 2017	TCU	99	96	98	100	95	98	586	0	99	98	100	98	99	100	594	0
Casey Lutz	TCU	Feb. 11, 2017	TCU	98	95	97	98	96	94	578	0	97	100	100	99	99	98	593	0
Mindy Miles	TCU	Feb. 11, 2017	TCU	94	97	99	98	95	99	582	0	100	100	98	100	100	96	594	0
Catherine Miller	TCU	Feb. 11, 2017	TCU	92	98	99	100	96	93	578	0	97	100	100	99	98	97	591	0
Meraleigh Randle	TCU	Feb. 11, 2017	TCU	0	0	0	0	0	0	0	0	0	0	0	0	0	0	0	0
Barrett Ray	TCU	Feb. 11, 2017	TCU	95	93	97	97	93	96	571	0	99	99	97	97	98	99	589	0
Jessica Kinder	UTEP	Feb. 11, 2017	TCU	0	0	0	0	0	0	0	0	0	0	0	0	0	0	0	0
Abby Monique	UTEP	Feb. 11, 2017	TCU	96	93	98	99	89	82	557	0	98	96	98	96	95	95	578	0
Maranda Nelson	UTEP	Feb. 11, 2017	TCU	95	93	98	94	90	91	561	0	95	94	97	91	96	96	569	0
Bailey Powell	UTEP	Feb. 11, 2017	TCU	95	96	100	96	94	96	577	0	97	99	99	98	99	99	591	0
Mara Rouse	UTEP	Feb. 11, 2017	TCU	95	94	97	97	93	88	564	0	92	93	91	94	96	91	557	0
Rachael Schoenrock	UTEP	Feb. 11, 2017	TCU	93	95	100	97	97	92	574	0	96	94	96	98	98	96	578	0
Haylee Schoenrock	UTEP	Feb. 11, 2017	TCU	92	92	95	99	94	96	568	0	97	99	95	99	98	98	586	0
Monthserrat Serna	UTEP	Feb. 11, 2017	TCU	0	0	0	0	0	0	0	0	0	0	0	0	0	0	0	0
Billy Azzinaro	Kentucky	Feb. 11, 2017	Kentucky	93	99	97	100	92	97	578	0	99	94	99	97	97	99	585	0
Jenna Bethea	Kentucky	Feb. 11, 2017	Kentucky	95	96	97	100	93	94	575	0	98	97	98	99	98	98	588	0
Hanna Carr	Kentucky	Feb. 11, 2017	Kentucky	97	95	97	100	92	99	580	0	97	97	98	97	97	97	583	0
Morgan Duerr	Kentucky	Feb. 11, 2017	Kentucky	91	93	98	98	92	92	564	0	94	95	99	97	98	98	581	0
Ian Foos	Kentucky	Feb. 11, 2017	Kentucky	90	90	97	96	92	93	558	0	97	98	96	97	96	100	584	0
Carmen Fry	Kentucky	Feb. 11, 2017	Kentucky	97	95	99	96	95	90	572	0	99	93	97	98	98	96	581	0
Heather Kirby	Kentucky	Feb. 11, 2017	Kentucky	96	96	99	99	92	93	575	0	99	98	99	99	99	100	594	0
Sonya May	Kentucky	Feb. 11, 2017	Kentucky	97	96	99	99	95	96	582	0	99	100	99	99	98	98	593	0
Andrew Miller	Kentucky	Feb. 11, 2017	Kentucky	0	0	0	0	0	0	0	0	0	0	0	0	0	0	0	0
Cathryn Papasodora	Kentucky	Feb. 11, 2017	Kentucky	96	93	99	99	89	93	569	0	96	98	98	100	97	99	588	0
Jason Scharbel	Kentucky	Feb. 11, 2017	Kentucky	96	97	96	100	95	92	576	0	96	98	98	98	98	97	585	0
Jason Spaude	Kentucky	Feb. 11, 2017	Kentucky	98	96	95	99	95	96	579	0	99	98	97	96	96	98	584	0
Jack Anderson	West Virginia	Feb. 11, 2017	Kentucky	89	87	89	95	90	92	542	0	97	99	92	99	97	95	579	0
Will Anti	West Virginia	Feb. 11, 2017	Kentucky	93	95	98	99	90	94	569	0	96	94	96	97	97	97	577	0
Milica Babic	West Virginia	Feb. 11, 2017	Kentucky	93	96	98	96	96	100	579	0	99	97	99	100	99	100	594	0
Noah Barker	West Virginia	Feb. 11, 2017	Kentucky	0	0	0	0	0	0	0	0	0	0	0	0	0	0	0	0
Elizabeth Gratz	West Virginia	Feb. 11, 2017	Kentucky	94	98	98	98	97	94	579	0	100	100	100	100	100	100	600	0
Jean-Pierre Lucas	West Virginia	Feb. 11, 2017	Kentucky	95	96	100	100	94	97	582	0	99	99	98	99	99	99	593	0
Morgan Phillips	West Virginia	Feb. 11, 2017	Kentucky	97	96	99	98	98	95	583	0	97	95	100	99	97	100	588	0
Ginny Thrasher	West Virginia	Feb. 11, 2017	Kentucky	99	98	100	100	98	97	592	0	100	99	99	100	98	99	595	0
Andrew Abernathy	North Georgia	Feb. 11, 2017	Ga. Southern	0	0	0	0	0	0	0	0	0	0	0	0	0	0	0	0
Eric Azotea	North Georgia	Feb. 11, 2017	Ga. Southern	0	0	0	0	0	0	0	0	0	0	0	0	0	0	0	0
Ruthanne Conner	North Georgia	Feb. 11, 2017	Ga. Southern	89	90	99	98	92	92	560	0	97	100	96	97	97	98	585	0
Lucas Gilliland	North Georgia	Feb. 11, 2017	Ga. Southern	89	90	97	95	83	79	533	0	94	95	96	91	91	96	563	0
Maddie Godwin	North Georgia	Feb. 11, 2017	Ga. Southern	0	0	0	0	0	0	0	0	0	0	0	0	0	0	0	0
Hannah Peevy	North Georgia	Feb. 11, 2017	Ga. Southern	0	0	0	0	0	0	0	0	0	0	0	0	0	0	0	0
Jared Rice	North Georgia	Feb. 11, 2017	Ga. Southern	0	0	0	0	0	0	0	0	0	0	0	0	0	0	0	0
Tobin Sanctuary	North Georgia	Feb. 11, 2017	Ga. Southern	93	94	97	99	92	89	564	0	96	96	93	93	93	89	560	0
Brianna Shaw	North Georgia	Feb. 11, 2017	Ga. Southern	90	87	95	92	87	86	537	0	97	95	90	93	97	97	569	0
Dakota Spivey	North Georgia	Feb. 11, 2017	Ga. Southern	0	0	0	0	0	0	0	0	0	0	0	0	0	0	0	0
David Turner	North Georgia	Feb. 11, 2017	Ga. Southern	95	95	95	91	90	88	554	0	93	95	95	96	94	94	567	0
Rosemary Kramer	Ga. Southern	Feb. 11, 2017	Ga. Southern	94	96	97	94	90	72	543	0	96	94	96	98	96	96	576	0
Tori Lewis	Ga. Southern	Feb. 11, 2017	Ga. Southern	95	90	92	93	93	86	549	0	95	96	94	93	97	93	568	0
Jennifer Middlebrook	Ga. Southern	Feb. 11, 2017	Ga. Southern	80	82	90	94	71	81	498	0	86	85	91	88	88	86	524	0
Lydia Odlin	Ga. Southern	Feb. 11, 2017	Ga. Southern	80	93	94	96	78	74	515	0	93	94	94	96	95	94	566	0
Chastity Price	Ga. Southern	Feb. 11, 2017	Ga. Southern	90	89	97	91	83	84	534	0	88	90	92	91	92	92	545	0
Courtney Weekley	Ga. Southern	Feb. 11, 2017	Ga. Southern	92	91	95	93	88	93	552	0	96	96	97	96	97	96	578	0
Kathryn Youngblood	Ga. Southern	Feb. 11, 2017	Ga. Southern	91	88	96	95	79	82	531	0	96	94	95	96	94	93	568	0
Allison Auten	Citadel	Feb. 11, 2017	Wofford	89	83	92	92	88	90	534	0	97	96	96	97	100	97	583	0
Matthew Davenport	Citadel	Feb. 11, 2017	Wofford	0	0	0	0	0	0	0	0	0	0	0	0	0	0	0	0
Joseph Ferguson	Citadel	Feb. 11, 2017	Wofford	0	0	0	0	0	0	0	0	0	0	0	0	0	0	0	0
Morgan Long	Citadel	Feb. 11, 2017	Wofford	88	85	95	91	82	88	529	0	97	94	91	98	95	96	571	0
Alexander McAlear	Citadel	Feb. 11, 2017	Wofford	86	90	95	94	87	88	540	0	94	92	96	95	96	95	568	0
Patrick Meyer	Citadel	Feb. 11, 2017	Wofford	91	92	98	96	86	82	545	0	94	93	94	94	95	88	558	0
Richie Parra	Citadel	Feb. 11, 2017	Wofford	0	0	0	0	0	0	0	0	0	0	0	0	0	0	0	0
Colton Poole	Citadel	Feb. 11, 2017	Wofford	92	96	94	96	84	89	551	0	96	97	95	99	97	96	580	0
Tommy Simrill	Citadel	Feb. 11, 2017	Wofford	0	0	0	0	0	0	0	0	0	0	0	0	0	0	0	0
Kealie Engels	Wofford	Feb. 11, 2017	Wofford	0	0	0	0	0	0	0	0	0	0	0	0	0	0	0	0
Seth Flanagan	Wofford	Feb. 11, 2017	Wofford	86	87	88	83	85	85	514	0	91	91	92	93	92	91	550	0
Cierra Holcombe	Wofford	Feb. 11, 2017	Wofford	88	93	94	90	88	89	542	0	94	97	96	94	94	94	569	0
Carson Howell	Wofford	Feb. 11, 2017	Wofford	0	0	0	0	0	0	0	0	0	0	0	0	0	0	0	0
Nicholas Hunter	Wofford	Feb. 11, 2017	Wofford	92	90	93	94	85	88	542	0	89	93	93	89	88	93	545	0
Zachry Hunter	Wofford	Feb. 11, 2017	Wofford	85	84	90	89	70	83	501	0	93	89	93	92	92	87	546	0
Reid Schuster	Wofford	Feb. 11, 2017	Wofford	91	83	87	89	74	78	502	0	89	86	90	90	88	90	533	0
Carli Cline	Citadel (W)	Feb. 11, 2017	Wofford	83	87	93	94	84	74	515	0	95	92	88	92	94	94	555	0
Brandi Duzz	Citadel (W)	Feb. 11, 2017	Wofford	75	84	91	94	74	89	507	0	91	91	97	92	97	91	559	0
Leah Fenwrick-Wallace	Citadel (W)	Feb. 11, 2017	Wofford	84	85	91	94	82	80	516	0	91	91	91	95	91	86	545	0
Shadonna Littlejohn	Citadel (W)	Feb. 11, 2017	Wofford	96	92	93	89	72	81	523	0	94	88	88	86	83	87	526	0
Tierra Price	Citadel (W)	Feb. 11, 2017	Wofford	0	0	0	0	0	0	0	0	0	0	0	0	0	0	0	0
Faith Totherow	Citadel (W)	Feb. 11, 2017	Wofford	90	92	92	92	82	79	527	0	89	86	93	91	89	91	539	0
Raven Wills	Citadel (W)	Feb. 11, 2017	Wofford	0	0	0	0	0	0	0	0	0	0	0	0	0	0	0	0
William Davidson	VMI	Feb. 11, 2017	VMI	90	89	97	99	89	84	548	0	95	89	95	88	95	97	559	0
Andrew Hickey	VMI	Feb. 11, 2017	VMI	0	0	0	0	0	0	0	0	96	97	98	99	99	92	581	0
Jacob Hunter	VMI	Feb. 11, 2017	VMI	86	92	97	95	92	85	547	0	96	97	96	94	98	94	575	0
Zachary Johnson	VMI	Feb. 11, 2017	VMI	94	94	98	97	90	87	560	0	0	0	0	0	0	0	0	0
Mathew Lusardi	VMI	Feb. 11, 2017	VMI	0	0	0	0	0	0	0	0	93	96	98	94	95	98	574	0
Chris Milliken	VMI	Feb. 11, 2017	VMI	90	89	96	97	91	89	552	0	91	93	97	94	96	94	565	0
John Pitman	VMI	Feb. 11, 2017	VMI	89	94	97	94	88	84	546	0	0	0	0	0	0	0	0	0
Nick Reynolds	VMI	Feb. 11, 2017	VMI	90	90	98	93	85	89	545	0	97	92	93	91	92	90	555	0
Sarah Banks	Alabama Birmingham	Feb. 11, 2017	VMI	0	0	0	0	0	0	0	0	86	87	90	88	96	97	544	0
Steven Bugg	Alabama Birmingham	Feb. 11, 2017	VMI	0	0	0	0	0	0	0	0	0	0	0	0	0	0	0	0
Selina Curren	Alabama Birmingham	Feb. 11, 2017	VMI	93	91	98	94	84	91	551	0	91	93	94	94	92	95	559	0
Lindsey Hill	Alabama Birmingham	Feb. 11, 2017	VMI	0	0	0	0	0	0	0	0	90	80	86	88	86	86	516	0
Isaac King	Alabama Birmingham	Feb. 11, 2017	VMI	0	0	0	0	0	0	0	0	0	0	0	0	0	0	0	0
Kristie Lloyd	Alabama Birmingham	Feb. 11, 2017	VMI	0	0	0	0	0	0	0	0	90	91	94	95	92	93	555	0
Logan Short	Alabama Birmingham	Feb. 11, 2017	VMI	0	0	0	0	0	0	0	0	0	0	0	0	0	0	0	0
Mallory Sisk	Alabama Birmingham	Feb. 11, 2017	VMI	0	0	0	0	0	0	0	0	0	0	0	0	0	0	0	0
Micah Smith	Alabama Birmingham	Feb. 11, 2017	VMI	0	0	0	0	0	0	0	0	0	0	0	0	0	0	0	0
Emily Stover	Alabama Birmingham	Feb. 11, 2017	VMI	0	0	0	0	0	0	0	0	93	91	90	91	95	95	555	0
Ella Von Canon	Alabama Birmingham	Feb. 11, 2017	VMI	0	0	0	0	0	0	0	0	0	0	0	0	0	0	0	0
Lilly Vonderau	Alabama Birmingham	Feb. 11, 2017	VMI	0	0	0	0	0	0	0	0	100	99	95	97	94	97	582	0
Kelia Aardema	VMI (W)	Feb. 11, 2017	VMI	86	86	93	88	71	84	508	0	0	0	0	0	0	0	0	0
Samantha Alexander	VMI (W)	Feb. 11, 2017	VMI	91	90	97	94	84	90	546	0	93	97	96	94	95	96	571	0
Ellana Avery	VMI (W)	Feb. 11, 2017	VMI	0	0	0	0	0	0	0	0	0	0	0	0	0	0	0	0
Sabrina Bell	VMI (W)	Feb. 11, 2017	VMI	0	0	0	0	0	0	0	0	95	91	94	94	93	92	559	0
Alice Chiu	VMI (W)	Feb. 11, 2017	VMI	0	0	0	0	0	0	0	0	0	0	0	0	0	0	0	0
Jamie Foster	VMI (W)	Feb. 11, 2017	VMI	0	0	0	0	0	0	0	0	87	89	90	88	85	95	534	0
Joelle Henry	VMI (W)	Feb. 11, 2017	VMI	0	0	0	0	0	0	0	0	93	88	92	92	88	91	544	0
Rachel Jankelow	VMI (W)	Feb. 11, 2017	VMI	87	93	95	96	87	89	547	0	93	91	86	88	95	92	545	0
Kerrie Lightfoot	VMI (W)	Feb. 11, 2017	VMI	79	77	79	78	75	86	474	0	88	86	95	92	92	97	550	0
Loyce Lightfoot	VMI (W)	Feb. 11, 2017	VMI	92	88	96	91	85	84	536	0	0	0	0	0	0	0	0	0
Kaitlyn Morrison	VMI (W)	Feb. 11, 2017	VMI	0	0	0	0	0	0	0	0	91	91	92	93	92	95	554	0
Katherine Watson	VMI (W)	Feb. 11, 2017	VMI	88	86	97	93	89	89	542	0	89	89	93	93	94	88	546	0
Gavin Asbury	VMI	Feb. 11, 2017	VMI	86	79	96	95	77	81	514	0	0	0	0	0	0	0	0	0
George Conde	John Jay	Feb. 11, 2017	USciences	0	0	0	0	0	0	0	0	0	0	0	0	0	0	0	0
Angelica Dearaujo	John Jay	Feb. 11, 2017	USciences	88	86	94	93	86	89	536	0	95	97	95	93	96	95	571	0
Lily Graham	John Jay	Feb. 11, 2017	USciences	98	99	95	97	87	91	567	0	97	97	95	96	98	92	575	0
Ronald Kopec	John Jay	Feb. 11, 2017	USciences	95	83	91	93	89	87	538	0	92	91	96	93	91	97	560	0
Eliza Kotowska	John Jay	Feb. 11, 2017	USciences	0	0	0	0	0	0	0	0	88	91	89	92	95	92	547	0
Susana Sanchez	John Jay	Feb. 11, 2017	USciences	0	0	0	0	0	0	0	0	0	0	0	0	0	0	0	0
Ida Sato	John Jay	Feb. 11, 2017	USciences	85	86	82	89	81	87	510	0	90	89	93	91	84	90	537	0
Marc Suda	John Jay	Feb. 11, 2017	USciences	84	79	92	92	87	82	516	0	94	85	92	92	94	90	547	0
Rachel Hubal	USciences	Feb. 11, 2017	USciences	83	81	94	90	86	83	517	0	80	81	86	85	85	91	508	0
Angela Kang	USciences	Feb. 11, 2017	USciences	85	90	91	91	91	81	529	0	87	91	88	93	92	93	544	0
Brittany Mahoney	USciences	Feb. 11, 2017	USciences	52	68	89	92	68	74	443	0	68	82	82	83	82	69	466	0
Chris Makosiej	USciences	Feb. 11, 2017	USciences	0	0	0	0	0	0	0	0	0	0	0	0	0	0	0	0
Nick Makosiej	USciences	Feb. 11, 2017	USciences	83	75	84	87	62	75	466	0	84	72	74	78	80	78	466	0
Thomas Nelligan	USciences	Feb. 11, 2017	USciences	22	39	70	49	19	37	236	0	54	60	53	47	44	58	316	0
Matt Popowicz	USciences	Feb. 11, 2017	USciences	86	89	93	92	79	87	526	0	86	87	85	76	82	83	499	0
Andrej Quatrone	USciences	Feb. 11, 2017	USciences	89	91	96	92	94	85	547	0	85	85	89	92	89	93	533	0
Sarah Schnupp	USciences	Feb. 11, 2017	USciences	96	95	99	97	94	93	574	0	94	98	96	96	94	93	571	0
Lauren Stabler	USciences	Feb. 11, 2017	USciences	90	87	88	94	83	74	516	0	88	82	84	81	90	88	513	0
Christina Tipton	USciences	Feb. 11, 2017	USciences	70	81	83	87	66	43	430	0	75	77	74	67	73	71	437	0
Allie Tuman	USciences	Feb. 11, 2017	USciences	85	89	92	91	76	81	514	0	84	87	92	84	89	91	527	0
Anita Varkey	USciences	Feb. 11, 2017	USciences	60	63	83	89	75	66	436	0	79	82	81	81	83	84	490	0
Andrew Visconti	USciences	Feb. 11, 2017	USciences	92	92	96	97	86	87	550	0	92	91	92	94	94	93	556	0
Nick Zsoldos	USciences	Feb. 11, 2017	USciences	91	93	93	92	80	77	526	0	91	93	90	82	88	91	535	0
Seth Baker	Morehead St.	Feb. 11, 2017	Jacksonville St.	100	98	100	98	94	89	579	0	93	96	99	94	95	98	575	0
Brandon Bryer	Morehead St.	Feb. 11, 2017	Jacksonville St.	95	98	96	100	93	97	579	0	94	96	98	97	98	96	579	0
Siarra Crum	Morehead St.	Feb. 11, 2017	Jacksonville St.	91	90	94	97	93	91	556	0	96	96	98	95	95	98	578	0
Sarah Fink	Morehead St.	Feb. 11, 2017	Jacksonville St.	96	95	98	99	90	93	571	0	99	99	97	96	95	94	580	0
Joe Fischer	Morehead St.	Feb. 11, 2017	Jacksonville St.	94	96	100	100	94	90	574	0	97	96	97	94	98	95	577	0
Dan Hall	Morehead St.	Feb. 11, 2017	Jacksonville St.	99	95	98	99	92	86	569	0	93	94	93	96	95	94	565	0
Jesse Moyer	Morehead St.	Feb. 11, 2017	Jacksonville St.	94	97	98	97	92	89	567	0	99	95	96	96	99	98	583	0
Alexa Potts	Morehead St.	Feb. 11, 2017	Jacksonville St.	96	96	97	98	95	93	575	0	95	95	96	97	95	95	573	0
Karly Potts	Morehead St.	Feb. 11, 2017	Jacksonville St.	94	98	97	97	93	90	569	0	96	95	97	98	98	98	582	0
Melanie West	Morehead St.	Feb. 11, 2017	Jacksonville St.	90	96	95	97	90	88	556	0	92	92	94	96	98	89	561	0
Haley Wilson	Morehead St.	Feb. 11, 2017	Jacksonville St.	0	0	0	0	0	0	0	0	0	0	0	0	0	0	0	0
Hunter Behrends	Jacksonville St.	Feb. 11, 2017	Jacksonville St.	96	98	98	99	85	90	566	0	95	93	99	93	95	92	567	0
Austin Cock	Jacksonville St.	Feb. 11, 2017	Jacksonville St.	95	95	98	100	89	89	566	0	93	94	97	96	98	97	575	0
Anika Corsi	Jacksonville St.	Feb. 11, 2017	Jacksonville St.	97	92	98	93	87	88	555	0	97	92	98	97	96	95	575	0
Trace Haynes	Jacksonville St.	Feb. 11, 2017	Jacksonville St.	96	94	97	100	100	93	580	0	97	98	98	98	97	99	587	0
Brandon Henson	Jacksonville St.	Feb. 11, 2017	Jacksonville St.	97	96	95	96	93	92	569	0	92	94	95	98	98	97	574	0
Brandon Muske	Jacksonville St.	Feb. 11, 2017	Jacksonville St.	98	99	95	99	96	95	582	0	97	100	99	98	98	97	589	0
Kyle Ordille	Jacksonville St.	Feb. 11, 2017	Jacksonville St.	91	94	97	100	88	89	559	0	93	98	96	99	94	94	574	0
Carleigh Peters	Jacksonville St.	Feb. 11, 2017	Jacksonville St.	89	94	97	97	87	95	559	0	94	98	95	96	98	93	574	0
Garrett Rabel	Jacksonville St.	Feb. 11, 2017	Jacksonville St.	97	96	99	99	91	91	573	0	95	97	96	93	98	97	576	0
Tyler Ramos	Jacksonville St.	Feb. 11, 2017	Jacksonville St.	0	0	0	0	0	0	0	0	0	0	0	0	0	0	0	0
Mekenna Richardson	Jacksonville St.	Feb. 11, 2017	Jacksonville St.	99	98	98	98	94	94	581	0	98	98	93	99	98	98	584	0
Carter Santrock	Jacksonville St.	Feb. 11, 2017	Jacksonville St.	97	95	98	98	92	96	576	0	96	96	99	98	96	94	579	0
Zach Schmidt	Jacksonville St.	Feb. 11, 2017	Jacksonville St.	94	94	95	98	93	91	565	0	98	98	98	99	96	94	583	0
David Sink	Jacksonville St.	Feb. 11, 2017	Jacksonville St.	97	97	97	98	95	95	579	0	96	95	96	93	92	96	568	0
Bobby Broadstreet	Murray St.	Feb. 12, 2017	Kentucky	95	94	97	100	94	94	574	0	96	98	96	100	98	98	586	0
Meike Drewell	Murray St.	Feb. 12, 2017	Kentucky	0	0	0	0	0	0	0	0	0	0	0	0	0	0	0	0
Ben Estes	Murray St.	Feb. 12, 2017	Kentucky	96	97	100	99	98	95	585	0	98	97	99	99	97	97	587	0
Shelby Huber	Murray St.	Feb. 12, 2017	Kentucky	0	0	0	0	0	0	0	0	0	0	0	0	0	0	0	0
Mackenzie Martin	Murray St.	Feb. 12, 2017	Kentucky	98	98	99	100	95	97	587	0	99	100	100	99	99	99	596	0
Ivan Roe	Murray St.	Feb. 12, 2017	Kentucky	98	99	98	99	95	98	587	0	100	99	100	100	99	100	598	0
Barbara Schlapfer	Murray St.	Feb. 12, 2017	Kentucky	99	97	97	100	95	93	581	0	98	98	97	98	98	99	588	0
Alathea Sellars	Murray St.	Feb. 12, 2017	Kentucky	94	96	97	99	94	93	573	0	97	99	99	97	99	100	591	0
Eric Sloan	Murray St.	Feb. 12, 2017	Kentucky	0	0	0	0	0	0	0	0	0	0	0	0	0	0	0	0
Jack Anderson	West Virginia	Feb. 12, 2017	Kentucky	90	89	94	93	90	94	550	0	97	98	98	96	99	97	585	0
Will Anti	West Virginia	Feb. 12, 2017	Kentucky	93	94	99	98	92	96	572	0	98	99	98	97	96	98	586	0
Milica Babic	West Virginia	Feb. 12, 2017	Kentucky	96	95	99	100	96	98	584	0	99	100	100	100	100	100	599	0
Noah Barker	West Virginia	Feb. 12, 2017	Kentucky	0	0	0	0	0	0	0	0	0	0	0	0	0	0	0	0
Elizabeth Gratz	West Virginia	Feb. 12, 2017	Kentucky	97	98	99	100	96	97	587	0	100	100	100	100	100	98	598	0
Jean-Pierre Lucas	West Virginia	Feb. 12, 2017	Kentucky	97	96	99	99	99	98	588	0	98	98	97	98	100	95	586	0
Morgan Phillips	West Virginia	Feb. 12, 2017	Kentucky	95	99	100	99	94	97	584	0	98	99	98	96	98	99	588	0
Ginny Thrasher	West Virginia	Feb. 12, 2017	Kentucky	99	95	98	100	96	98	586	0	99	100	100	98	100	99	596	0
